wc_year,country,home_goals,home_conceded,away_goals,away_conceded,total_goals,total_conceded,home_gd_ratio,away_gd_ratio,total_gd_ratio
2002,Algeria,57,34,37,49,94,83,1.6764705882352942,0.7551020408163265,1.1325301204819278
2006,Algeria,34,25,29,41,63,66,1.36,0.7073170731707317,0.9545454545454546
2010,Algeria,40,16,25,41,65,57,2.5,0.6097560975609756,1.1403508771929824
2014,Algeria,63,10,44,39,107,49,6.3,1.1282051282051282,2.183673469387755
2018,Algeria,68,14,58,47,126,61,4.857142857142857,1.2340425531914894,2.0655737704918034
2022,Algeria,72,19,70,27,142,46,3.789473684210526,2.5925925925925926,3.0869565217391304
2002,Greece,56,34,39,40,95,74,1.6470588235294117,0.975,1.2837837837837838
2006,Greece,39,17,56,46,95,63,2.2941176470588234,1.2173913043478262,1.507936507936508
2010,Greece,46,25,49,42,95,67,1.84,1.1666666666666667,1.4179104477611941
2014,Greece,28,22,42,33,70,55,1.2727272727272727,1.2727272727272727,1.2727272727272727
2018,Greece,29,24,30,32,59,56,1.2083333333333333,0.9375,1.0535714285714286
2022,Greece,46,23,39,31,85,54,2.0,1.2580645161290323,1.5740740740740742
2002,Mexico,82,16,86,65,168,81,5.125,1.323076923076923,2.074074074074074
2006,Mexico,82,13,106,76,188,89,6.3076923076923075,1.394736842105263,2.1123595505617976
2010,Mexico,51,19,151,78,202,97,2.6842105263157894,1.935897435897436,2.082474226804124
2014,Mexico,26,8,138,79,164,87,3.25,1.7468354430379747,1.8850574712643677
2018,Mexico,29,7,122,78,151,85,4.142857142857143,1.564102564102564,1.776470588235294
2022,Mexico,31,6,132,80,163,86,5.166666666666667,1.65,1.8953488372093024
2002,Malawi,42,48,23,49,65,97,0.875,0.46938775510204084,0.6701030927835051
2006,Malawi,34,29,41,62,75,91,1.1724137931034482,0.6612903225806451,0.8241758241758241
2010,Malawi,36,19,45,61,81,80,1.894736842105263,0.7377049180327869,1.0125
2014,Malawi,23,19,38,58,61,77,1.2105263157894737,0.6551724137931034,0.7922077922077922
2018,Malawi,9,5,32,44,41,49,1.8,0.7272727272727273,0.8367346938775511
2022,Malawi,12,13,38,59,50,72,0.9230769230769231,0.6440677966101694,0.6944444444444444
2002,Eswatini,35,31,25,63,60,94,1.1290322580645162,0.3968253968253968,0.6382978723404256
2006,Eswatini,18,27,22,67,40,94,0.6666666666666666,0.3283582089552239,0.425531914893617
2010,Eswatini,12,28,17,45,29,73,0.42857142857142855,0.37777777777777777,0.3972602739726027
2014,Eswatini,12,25,27,53,39,78,0.48,0.5094339622641509,0.5
2018,Eswatini,9,17,30,46,39,63,0.5294117647058824,0.6521739130434783,0.6190476190476191
2022,Eswatini,2,7,42,56,44,63,0.2857142857142857,0.75,0.6984126984126984
2002,Botswana,33,23,17,33,50,56,1.434782608695652,0.5151515151515151,0.8928571428571429
2006,Botswana,22,17,25,41,47,58,1.2941176470588236,0.6097560975609756,0.8103448275862069
2010,Botswana,26,15,27,44,53,59,1.7333333333333334,0.6136363636363636,0.8983050847457628
2014,Botswana,47,30,28,62,75,92,1.5666666666666667,0.45161290322580644,0.8152173913043478
2018,Botswana,20,15,28,45,48,60,1.3333333333333333,0.6222222222222222,0.8
2022,Botswana,10,14,25,34,35,48,0.7142857142857143,0.7352941176470589,0.7291666666666666
2002,Kuwait,87,25,43,48,130,73,3.48,0.8958333333333334,1.7808219178082192
2006,Kuwait,56,33,45,51,101,84,1.696969696969697,0.8823529411764706,1.2023809523809523
2010,Kuwait,46,39,68,60,114,99,1.1794871794871795,1.1333333333333333,1.1515151515151516
2014,Kuwait,32,21,57,61,89,82,1.5238095238095237,0.9344262295081968,1.0853658536585367
2018,Kuwait,26,17,22,18,48,35,1.5294117647058822,1.2222222222222223,1.3714285714285714
2022,Kuwait,35,25,36,44,71,69,1.4,0.8181818181818182,1.0289855072463767
2002,France,73,16,63,24,136,40,4.5625,2.625,3.4
2006,France,71,15,50,28,121,43,4.733333333333333,1.7857142857142858,2.813953488372093
2010,France,54,22,46,33,100,55,2.4545454545454546,1.393939393939394,1.8181818181818181
2014,France,98,32,37,27,135,59,3.0625,1.3703703703703705,2.288135593220339
2018,France,105,43,35,19,140,62,2.441860465116279,1.8421052631578947,2.2580645161290325
2022,France,88,24,62,29,150,53,3.6666666666666665,2.1379310344827585,2.830188679245283
2002,Liberia,27,9,21,46,48,55,3.0,0.45652173913043476,0.8727272727272727
2006,Liberia,15,18,10,48,25,66,0.8333333333333334,0.20833333333333334,0.3787878787878788
2010,Liberia,20,15,11,40,31,55,1.3333333333333333,0.275,0.5636363636363636
2014,Liberia,24,14,12,35,36,49,1.7142857142857142,0.34285714285714286,0.7346938775510204
2018,Liberia,18,9,8,23,26,32,2.0,0.34782608695652173,0.8125
2022,Liberia,6,10,19,48,25,58,0.6,0.3958333333333333,0.43103448275862066
2002,Nigeria,55,16,54,42,109,58,3.4375,1.2857142857142858,1.8793103448275863
2006,Nigeria,33,10,56,41,89,51,3.3,1.3658536585365855,1.7450980392156863
2010,Nigeria,50,10,49,40,99,50,5.0,1.225,1.98
2014,Nigeria,53,17,54,37,107,54,3.1176470588235294,1.4594594594594594,1.9814814814814814
2018,Nigeria,29,12,50,39,79,51,2.4166666666666665,1.2820512820512822,1.5490196078431373
2022,Nigeria,31,13,63,50,94,63,2.3846153846153846,1.26,1.492063492063492
2002,United Arab Emirates,62,37,39,45,101,82,1.6756756756756757,0.8666666666666667,1.2317073170731707
2006,United Arab Emirates,62,59,39,52,101,111,1.0508474576271187,0.75,0.9099099099099099
2010,United Arab Emirates,68,49,41,55,109,104,1.3877551020408163,0.7454545454545455,1.0480769230769231
2014,United Arab Emirates,94,26,45,46,139,72,3.6153846153846154,0.9782608695652174,1.9305555555555556
2018,United Arab Emirates,67,27,40,36,107,63,2.4814814814814814,1.1111111111111112,1.6984126984126984
2022,United Arab Emirates,76,36,37,24,113,60,2.111111111111111,1.5416666666666667,1.8833333333333333
2002,Ivory Coast,57,12,40,32,97,44,4.75,1.25,2.2045454545454546
2006,Ivory Coast,38,4,83,53,121,57,9.5,1.5660377358490567,2.1228070175438596
2010,Ivory Coast,39,4,103,50,142,54,9.75,2.06,2.6296296296296298
2014,Ivory Coast,38,15,84,47,122,62,2.533333333333333,1.7872340425531914,1.967741935483871
2018,Ivory Coast,34,15,50,35,84,50,2.2666666666666666,1.4285714285714286,1.68
2022,Ivory Coast,58,20,55,34,113,54,2.9,1.6176470588235294,2.0925925925925926
2002,Thailand,78,44,88,65,166,109,1.7727272727272727,1.353846153846154,1.5229357798165137
2006,Thailand,78,46,38,40,116,86,1.6956521739130435,0.95,1.3488372093023255
2010,Thailand,90,31,33,42,123,73,2.903225806451613,0.7857142857142857,1.6849315068493151
2014,Thailand,73,31,40,48,113,79,2.3548387096774195,0.8333333333333334,1.4303797468354431
2018,Thailand,48,31,31,35,79,66,1.5483870967741935,0.8857142857142857,1.196969696969697
2022,Thailand,40,17,74,60,114,77,2.3529411764705883,1.2333333333333334,1.4805194805194806
2002,Colombia,36,17,64,57,100,74,2.1176470588235294,1.1228070175438596,1.3513513513513513
2006,Colombia,34,15,59,70,93,85,2.2666666666666666,0.8428571428571429,1.0941176470588236
2010,Colombia,39,17,50,50,89,67,2.2941176470588234,1.0,1.328358208955224
2014,Colombia,33,10,57,38,90,48,3.3,1.5,1.875
2018,Colombia,18,10,66,47,84,57,1.8,1.4042553191489362,1.4736842105263157
2022,Colombia,25,12,78,46,103,58,2.0833333333333335,1.6956521739130435,1.7758620689655173
2002,Indonesia,60,20,72,65,132,85,3.0,1.1076923076923078,1.5529411764705883
2006,Indonesia,38,24,51,57,89,81,1.5833333333333333,0.8947368421052632,1.0987654320987654
2010,Indonesia,73,42,18,49,91,91,1.7380952380952381,0.3673469387755102,1.0
2014,Indonesia,40,31,26,57,66,88,1.2903225806451613,0.45614035087719296,0.75
2018,Indonesia,39,34,17,30,56,64,1.1470588235294117,0.5666666666666667,0.875
2022,Indonesia,45,30,75,82,120,112,1.5,0.9146341463414634,1.0714285714285714
2002,Iran,93,21,95,57,188,78,4.428571428571429,1.6666666666666667,2.41025641025641
2006,Iran,100,25,67,40,167,65,4.0,1.675,2.5692307692307694
2010,Iran,84,18,75,54,159,72,4.666666666666667,1.3888888888888888,2.2083333333333335
2014,Iran,76,11,71,28,147,39,6.909090909090909,2.5357142857142856,3.769230769230769
2018,Iran,59,6,71,28,130,34,9.833333333333334,2.5357142857142856,3.823529411764706
2022,Iran,52,5,93,34,145,39,10.4,2.735294117647059,3.717948717948718
2002,United States,103,26,26,28,129,54,3.9615384615384617,0.9285714285714286,2.388888888888889
2006,United States,133,30,30,31,163,61,4.433333333333334,0.967741935483871,2.6721311475409837
2010,United States,109,62,37,40,146,102,1.7580645161290323,0.925,1.4313725490196079
2014,United States,114,63,48,48,162,111,1.8095238095238095,1.0,1.4594594594594594
2018,United States,123,53,39,35,162,88,2.3207547169811322,1.1142857142857143,1.8409090909090908
2022,United States,149,44,32,21,181,65,3.3863636363636362,1.5238095238095237,2.7846153846153845
2002,Costa Rica,60,25,66,68,126,93,2.4,0.9705882352941176,1.3548387096774193
2006,Costa Rica,61,22,63,81,124,103,2.772727272727273,0.7777777777777778,1.203883495145631
2010,Costa Rica,57,24,68,74,125,98,2.375,0.918918918918919,1.2755102040816326
2014,Costa Rica,40,19,67,69,107,88,2.1052631578947367,0.9710144927536232,1.2159090909090908
2018,Costa Rica,23,10,54,70,77,80,2.3,0.7714285714285715,0.9625
2022,Costa Rica,28,14,57,66,85,80,2.0,0.8636363636363636,1.0625
2002,South Korea,82,24,51,36,133,60,3.4166666666666665,1.4166666666666667,2.216666666666667
2006,South Korea,89,31,56,36,145,67,2.870967741935484,1.5555555555555556,2.1641791044776117
2010,South Korea,63,24,64,45,127,69,2.625,1.4222222222222223,1.8405797101449275
2014,South Korea,78,33,61,50,139,83,2.3636363636363638,1.22,1.6746987951807228
2018,South Korea,58,16,69,46,127,62,3.625,1.5,2.0483870967741935
2022,South Korea,72,23,71,33,143,56,3.130434782608696,2.1515151515151514,2.5535714285714284
2002,Malta,18,63,12,62,30,125,0.2857142857142857,0.1935483870967742,0.24
2006,Malta,26,57,10,75,36,132,0.45614035087719296,0.13333333333333333,0.2727272727272727
2010,Malta,24,44,13,65,37,109,0.5454545454545454,0.2,0.3394495412844037
2014,Malta,17,38,12,56,29,94,0.4473684210526316,0.21428571428571427,0.30851063829787234
2018,Malta,22,47,10,60,32,107,0.46808510638297873,0.16666666666666666,0.29906542056074764
2022,Malta,34,56,15,54,49,110,0.6071428571428571,0.2777777777777778,0.44545454545454544
2002,Uganda,52,34,57,65,109,99,1.5294117647058822,0.8769230769230769,1.101010101010101
2006,Uganda,32,18,61,60,93,78,1.7777777777777777,1.0166666666666666,1.1923076923076923
2010,Uganda,56,11,63,44,119,55,5.090909090909091,1.4318181818181819,2.1636363636363636
2014,Uganda,42,6,48,50,90,56,7.0,0.96,1.6071428571428572
2018,Uganda,19,3,36,37,55,40,6.333333333333333,0.972972972972973,1.375
2022,Uganda,11,4,30,44,41,48,2.75,0.6818181818181818,0.8541666666666666
2002,Togo,40,14,25,57,65,71,2.857142857142857,0.43859649122807015,0.9154929577464789
2006,Togo,39,14,32,40,71,54,2.7857142857142856,0.8,1.3148148148148149
2010,Togo,19,12,31,62,50,74,1.5833333333333333,0.5,0.6756756756756757
2014,Togo,25,16,26,50,51,66,1.5625,0.52,0.7727272727272727
2018,Togo,22,11,23,39,45,50,2.0,0.5897435897435898,0.9
2022,Togo,14,20,28,31,42,51,0.7,0.9032258064516129,0.8235294117647058
2002,Bermuda,38,22,14,11,52,33,1.7272727272727273,1.2727272727272727,1.5757575757575757
2006,Bermuda,34,26,14,17,48,43,1.3076923076923077,0.8235294117647058,1.1162790697674418
2010,Bermuda,18,18,6,5,24,23,1.0,1.2,1.0434782608695652
2014,Bermuda,12,5,6,3,18,8,2.4,2.0,2.25
2018,Bermuda,25,17,20,19,45,36,1.4705882352941178,1.0526315789473684,1.25
2022,Bermuda,17,22,41,55,58,77,0.7727272727272727,0.7454545454545455,0.7532467532467533
2002,Egypt,105,40,39,40,144,80,2.625,0.975,1.8
2006,Egypt,112,34,43,39,155,73,3.2941176470588234,1.1025641025641026,2.1232876712328768
2010,Egypt,61,19,87,46,148,65,3.210526315789474,1.891304347826087,2.276923076923077
2014,Egypt,55,13,63,45,118,58,4.230769230769231,1.4,2.0344827586206895
2018,Egypt,54,10,22,20,76,30,5.4,1.1,2.533333333333333
2022,Egypt,53,8,41,27,94,35,6.625,1.5185185185185186,2.6857142857142855
2002,Iraq,28,5,112,82,140,87,5.6,1.3658536585365855,1.6091954022988506
2006,Iraq,0,0,123,95,123,95,,1.2947368421052632,1.2947368421052632
2010,Iraq,11,7,85,70,96,77,1.5714285714285714,1.2142857142857142,1.2467532467532467
2014,Iraq,6,8,83,88,89,96,0.75,0.9431818181818182,0.9270833333333334
2018,Iraq,18,10,67,57,85,67,1.8,1.1754385964912282,1.2686567164179106
2022,Iraq,31,9,48,40,79,49,3.4444444444444446,1.2,1.6122448979591837
2002,Belgium,44,31,45,38,89,69,1.4193548387096775,1.1842105263157894,1.289855072463768
2006,Belgium,48,32,23,41,71,73,1.5,0.5609756097560976,0.9726027397260274
2010,Belgium,51,35,28,43,79,78,1.457142857142857,0.6511627906976745,1.0128205128205128
2014,Belgium,79,31,56,26,135,57,2.5483870967741935,2.1538461538461537,2.3684210526315788
2018,Belgium,104,24,73,30,177,54,4.333333333333333,2.433333333333333,3.2777777777777777
2022,Belgium,88,21,68,36,156,57,4.190476190476191,1.8888888888888888,2.736842105263158
2002,Gambia,16,7,2,22,18,29,2.2857142857142856,0.09090909090909091,0.6206896551724138
2006,Gambia,16,6,8,22,24,28,2.6666666666666665,0.36363636363636365,0.8571428571428571
2010,Gambia,17,9,17,35,34,44,1.8888888888888888,0.4857142857142857,0.7727272727272727
2014,Gambia,10,15,10,27,20,42,0.6666666666666666,0.37037037037037035,0.47619047619047616
2018,Gambia,12,15,16,17,28,32,0.8,0.9411764705882353,0.875
2022,Gambia,6,5,45,47,51,52,1.2,0.9574468085106383,0.9807692307692307
2002,Morocco,47,15,45,35,92,50,3.1333333333333333,1.2857142857142858,1.84
2006,Morocco,61,14,45,29,106,43,4.357142857142857,1.5517241379310345,2.4651162790697674
2010,Morocco,45,19,36,34,81,53,2.3684210526315788,1.0588235294117647,1.528301886792453
2014,Morocco,61,20,19,27,80,47,3.05,0.7037037037037037,1.702127659574468
2018,Morocco,52,19,33,14,85,33,2.736842105263158,2.357142857142857,2.5757575757575757
2022,Morocco,74,19,36,17,110,36,3.8947368421052633,2.1176470588235294,3.0555555555555554
2002,Netherlands,77,27,60,32,137,59,2.8518518518518516,1.875,2.3220338983050848
2006,Netherlands,73,20,68,32,141,52,3.65,2.125,2.7115384615384617
2010,Netherlands,88,18,67,39,155,57,4.888888888888889,1.7179487179487178,2.719298245614035
2014,Netherlands,81,30,57,44,138,74,2.7,1.2954545454545454,1.864864864864865
2018,Netherlands,58,30,52,33,110,63,1.9333333333333333,1.5757575757575757,1.746031746031746
2022,Netherlands,96,31,61,37,157,68,3.096774193548387,1.6486486486486487,2.3088235294117645
2002,Spain,91,16,51,28,142,44,5.6875,1.8214285714285714,3.227272727272727
2006,Spain,82,18,61,21,143,39,4.555555555555555,2.9047619047619047,3.6666666666666665
2010,Spain,68,7,118,40,186,47,9.714285714285714,2.95,3.9574468085106385
2014,Spain,63,9,96,33,159,42,7.0,2.909090909090909,3.7857142857142856
2018,Spain,84,11,68,30,152,41,7.636363636363637,2.2666666666666666,3.707317073170732
2022,Spain,92,15,74,34,166,49,6.133333333333334,2.176470588235294,3.3877551020408165
2002,Oman,105,47,47,43,152,90,2.234042553191489,1.0930232558139534,1.6888888888888889
2006,Oman,80,27,53,41,133,68,2.962962962962963,1.2926829268292683,1.9558823529411764
2010,Oman,64,44,44,53,108,97,1.4545454545454546,0.8301886792452831,1.1134020618556701
2014,Oman,65,32,31,51,96,83,2.03125,0.6078431372549019,1.1566265060240963
2018,Oman,60,14,28,43,88,57,4.285714285714286,0.6511627906976745,1.543859649122807
2022,Oman,32,13,43,37,75,50,2.4615384615384617,1.162162162162162,1.5
2002,Qatar,70,35,42,39,112,74,2.0,1.0769230769230769,1.5135135135135136
2006,Qatar,75,41,29,47,104,88,1.829268292682927,0.6170212765957447,1.1818181818181819
2010,Qatar,67,56,32,59,99,115,1.1964285714285714,0.5423728813559322,0.8608695652173913
2014,Qatar,108,36,35,47,143,83,3.0,0.7446808510638298,1.7228915662650603
2018,Qatar,80,30,53,51,133,81,2.6666666666666665,1.0392156862745099,1.6419753086419753
2022,Qatar,56,20,69,70,125,90,2.8,0.9857142857142858,1.3888888888888888
2002,Bahrain,35,18,53,58,88,76,1.9444444444444444,0.9137931034482759,1.1578947368421053
2006,Bahrain,69,43,62,76,131,119,1.6046511627906976,0.8157894736842105,1.1008403361344539
2010,Bahrain,84,35,57,81,141,116,2.4,0.7037037037037037,1.2155172413793103
2014,Bahrain,39,18,44,51,83,69,2.1666666666666665,0.8627450980392157,1.2028985507246377
2018,Bahrain,41,23,38,27,79,50,1.7826086956521738,1.4074074074074074,1.58
2022,Bahrain,64,44,36,28,100,72,1.4545454545454546,1.2857142857142858,1.3888888888888888
2002,Cameroon,19,1,60,41,79,42,19.0,1.4634146341463414,1.880952380952381
2006,Cameroon,25,6,59,46,84,52,4.166666666666667,1.2826086956521738,1.6153846153846154
2010,Cameroon,29,6,71,58,100,64,4.833333333333333,1.2241379310344827,1.5625
2014,Cameroon,33,9,46,44,79,53,3.6666666666666665,1.0454545454545454,1.490566037735849
2018,Cameroon,26,9,43,42,69,51,2.888888888888889,1.0238095238095237,1.3529411764705883
2022,Cameroon,46,15,32,31,78,46,3.066666666666667,1.032258064516129,1.6956521739130435
2002,Senegal,52,13,51,40,103,53,4.0,1.275,1.9433962264150944
2006,Senegal,46,11,58,56,104,67,4.181818181818182,1.0357142857142858,1.5522388059701493
2010,Senegal,35,9,45,51,80,60,3.888888888888889,0.8823529411764706,1.3333333333333333
2014,Senegal,27,6,49,44,76,50,4.5,1.1136363636363635,1.52
2018,Senegal,30,3,63,31,93,34,10.0,2.032258064516129,2.735294117647059
2022,Senegal,43,9,72,32,115,41,4.777777777777778,2.25,2.8048780487804876
2002,Mozambique,20,21,17,29,37,50,0.9523809523809523,0.5862068965517241,0.74
2006,Mozambique,38,16,12,27,50,43,2.375,0.4444444444444444,1.1627906976744187
2010,Mozambique,36,17,18,50,54,67,2.1176470588235294,0.36,0.8059701492537313
2014,Mozambique,27,12,21,53,48,65,2.25,0.39622641509433965,0.7384615384615385
2018,Mozambique,15,9,29,47,44,56,1.6666666666666667,0.6170212765957447,0.7857142857142857
2022,Mozambique,19,14,44,58,63,72,1.3571428571428572,0.7586206896551724,0.875
2002,Zambia,43,24,54,57,97,81,1.7916666666666667,0.9473684210526315,1.1975308641975309
2006,Zambia,40,17,74,61,114,78,2.3529411764705883,1.2131147540983607,1.4615384615384615
2010,Zambia,22,6,89,76,111,82,3.6666666666666665,1.1710526315789473,1.353658536585366
2014,Zambia,39,11,66,62,105,73,3.5454545454545454,1.064516129032258,1.4383561643835616
2018,Zambia,27,18,49,60,76,78,1.5,0.8166666666666667,0.9743589743589743
2022,Zambia,31,17,63,72,94,89,1.8235294117647058,0.875,1.0561797752808988
2002,Lesotho,25,33,16,48,41,81,0.7575757575757576,0.3333333333333333,0.5061728395061729
2006,Lesotho,27,25,18,52,45,77,1.08,0.34615384615384615,0.5844155844155844
2010,Lesotho,6,5,25,65,31,70,1.2,0.38461538461538464,0.44285714285714284
2014,Lesotho,14,19,33,71,47,90,0.7368421052631579,0.4647887323943662,0.5222222222222223
2018,Lesotho,12,17,26,41,38,58,0.7058823529411765,0.6341463414634146,0.6551724137931034
2022,Lesotho,4,6,30,63,34,69,0.6666666666666666,0.47619047619047616,0.4927536231884058
2002,Angola,49,19,38,46,87,65,2.5789473684210527,0.8260869565217391,1.3384615384615384
2006,Angola,39,10,66,74,105,84,3.9,0.8918918918918919,1.25
2010,Angola,40,15,40,61,80,76,2.6666666666666665,0.6557377049180327,1.0526315789473684
2014,Angola,33,17,28,45,61,62,1.9411764705882353,0.6222222222222222,0.9838709677419355
2018,Angola,20,13,17,33,37,46,1.5384615384615385,0.5151515151515151,0.8043478260869565
2022,Angola,21,13,42,31,63,44,1.6153846153846154,1.3548387096774193,1.4318181818181819
2002,Jamaica,59,27,57,84,116,111,2.185185185185185,0.6785714285714286,1.045045045045045
2006,Jamaica,63,22,33,70,96,92,2.8636363636363638,0.4714285714285714,1.0434782608695652
2010,Jamaica,46,13,42,57,88,70,3.5384615384615383,0.7368421052631579,1.2571428571428571
2014,Jamaica,24,22,39,66,63,88,1.0909090909090908,0.5909090909090909,0.7159090909090909
2018,Jamaica,25,13,61,57,86,70,1.9230769230769231,1.0701754385964912,1.2285714285714286
2022,Jamaica,26,20,71,73,97,93,1.3,0.9726027397260274,1.043010752688172
2002,Hungary,54,46,31,29,85,75,1.173913043478261,1.0689655172413792,1.1333333333333333
2006,Hungary,45,34,37,50,82,84,1.3235294117647058,0.74,0.9761904761904762
2010,Hungary,52,33,33,43,85,76,1.5757575757575757,0.7674418604651163,1.118421052631579
2014,Hungary,53,32,39,37,92,69,1.65625,1.054054054054054,1.3333333333333333
2018,Hungary,42,28,30,43,72,71,1.5,0.6976744186046512,1.0140845070422535
2022,Hungary,48,33,41,42,89,75,1.4545454545454546,0.9761904761904762,1.1866666666666668
2002,Basque Country,16,7,0,0,16,7,2.2857142857142856,,2.2857142857142856
2006,Basque Country,9,4,6,5,15,9,2.25,1.2,1.6666666666666667
2010,Basque Country,10,5,6,4,16,9,2.0,1.5,1.7777777777777777
2014,Basque Country,16,5,4,2,20,7,3.2,2.0,2.857142857142857
2018,Basque Country,9,4,2,1,11,5,2.25,2.0,2.2
2022,Basque Country,2,1,0,0,2,1,2.0,,2.0
2002,Sint Maarten,0,0,1,3,1,3,,0.3333333333333333,0.3333333333333333
2014,Sint Maarten,2,0,0,0,2,0,,,
2018,Sint Maarten,4,2,13,50,17,52,2.0,0.26,0.3269230769230769
2022,Sint Maarten,1,1,44,69,45,70,1.0,0.6376811594202898,0.6428571428571429
2002,Saint Kitts and Nevis,44,19,10,26,54,45,2.3157894736842106,0.38461538461538464,1.2
2006,Saint Kitts and Nevis,30,16,12,31,42,47,1.875,0.3870967741935484,0.8936170212765957
2010,Saint Kitts and Nevis,13,8,15,21,28,29,1.625,0.7142857142857143,0.9655172413793104
2014,Saint Kitts and Nevis,11,6,17,17,28,23,1.8333333333333333,1.0,1.2173913043478262
2018,Saint Kitts and Nevis,20,16,30,29,50,45,1.25,1.0344827586206897,1.1111111111111112
2022,Saint Kitts and Nevis,20,17,31,50,51,67,1.1764705882352942,0.62,0.7611940298507462
2002,Saint Martin,4,8,3,8,7,16,0.5,0.375,0.4375
2006,Saint Martin,0,1,1,6,1,7,0.0,0.16666666666666666,0.14285714285714285
2010,Saint Martin,6,2,3,1,9,3,3.0,3.0,3.0
2014,Saint Martin,0,0,4,2,4,2,,2.0,2.0
2018,Saint Martin,0,0,19,38,19,38,,0.5,0.5
2022,Saint Martin,3,2,43,37,46,39,1.5,1.162162162162162,1.1794871794871795
2002,Northern Ireland,12,38,24,32,36,70,0.3157894736842105,0.75,0.5142857142857142
2006,Northern Ireland,32,36,19,29,51,65,0.8888888888888888,0.6551724137931034,0.7846153846153846
2010,Northern Ireland,31,25,16,39,47,64,1.24,0.41025641025641024,0.734375
2014,Northern Ireland,34,23,18,39,52,62,1.4782608695652173,0.46153846153846156,0.8387096774193549
2018,Northern Ireland,40,27,23,34,63,61,1.4814814814814814,0.6764705882352942,1.0327868852459017
2022,Northern Ireland,28,22,37,51,65,73,1.2727272727272727,0.7254901960784313,0.8904109589041096
2002,England,62,29,50,32,112,61,2.1379310344827585,1.5625,1.8360655737704918
2006,England,79,25,56,33,135,58,3.16,1.696969696969697,2.3275862068965516
2010,England,74,26,58,26,132,52,2.8461538461538463,2.230769230769231,2.5384615384615383
2014,England,67,22,65,29,132,51,3.0454545454545454,2.2413793103448274,2.588235294117647
2018,England,73,17,52,27,125,44,4.294117647058823,1.9259259259259258,2.840909090909091
2022,England,95,24,72,23,167,47,3.9583333333333335,3.130434782608696,3.5531914893617023
2002,Republic of Ireland,62,24,27,16,89,40,2.5833333333333335,1.6875,2.225
2006,Republic of Ireland,44,24,28,21,72,45,1.8333333333333333,1.3333333333333333,1.6
2010,Republic of Ireland,34,36,45,30,79,66,0.9444444444444444,1.5,1.196969696969697
2014,Republic of Ireland,59,31,42,40,101,71,1.903225806451613,1.05,1.4225352112676057
2018,Republic of Ireland,36,23,23,33,59,56,1.565217391304348,0.696969696969697,1.0535714285714286
2022,Republic of Ireland,38,29,27,36,65,65,1.3103448275862069,0.75,1.0
2002,Luxembourg,16,75,7,60,23,135,0.21333333333333335,0.11666666666666667,0.17037037037037037
2006,Luxembourg,13,67,10,72,23,139,0.19402985074626866,0.1388888888888889,0.16546762589928057
2010,Luxembourg,18,62,8,50,26,112,0.2903225806451613,0.16,0.23214285714285715
2014,Luxembourg,23,65,14,57,37,122,0.35384615384615387,0.24561403508771928,0.30327868852459017
2018,Luxembourg,32,51,18,52,50,103,0.6274509803921569,0.34615384615384615,0.4854368932038835
2022,Luxembourg,31,50,24,54,55,104,0.62,0.4444444444444444,0.5288461538461539
2002,Poland,42,27,67,46,109,73,1.5555555555555556,1.4565217391304348,1.4931506849315068
2006,Poland,65,38,88,50,153,88,1.7105263157894737,1.76,1.7386363636363635
2010,Poland,57,33,52,51,109,84,1.7272727272727273,1.0196078431372548,1.2976190476190477
2014,Poland,73,40,48,25,121,65,1.825,1.92,1.8615384615384616
2018,Poland,78,31,32,25,110,56,2.5161290322580645,1.28,1.9642857142857142
2022,Poland,67,29,46,51,113,80,2.310344827586207,0.9019607843137255,1.4125
2002,Russia,53,20,43,41,96,61,2.65,1.048780487804878,1.5737704918032787
2006,Russia,53,16,43,54,96,70,3.3125,0.7962962962962963,1.3714285714285714
2010,Russia,52,18,51,36,103,54,2.888888888888889,1.4166666666666667,1.9074074074074074
2014,Russia,57,18,48,32,105,50,3.1666666666666665,1.5,2.1
2018,Russia,59,39,43,37,102,76,1.5128205128205128,1.162162162162162,1.3421052631578947
2022,Russia,51,13,45,29,96,42,3.923076923076923,1.5517241379310345,2.2857142857142856
2002,Scotland,32,34,23,41,55,75,0.9411764705882353,0.5609756097560976,0.7333333333333333
2006,Scotland,38,32,20,33,58,65,1.1875,0.6060606060606061,0.8923076923076924
2010,Scotland,32,18,16,42,48,60,1.7777777777777777,0.38095238095238093,0.8
2014,Scotland,30,19,34,42,64,61,1.5789473684210527,0.8095238095238095,1.0491803278688525
2018,Scotland,42,30,31,35,73,65,1.4,0.8857142857142857,1.123076923076923
2022,Scotland,53,35,38,53,91,88,1.5142857142857142,0.7169811320754716,1.0340909090909092
2002,Switzerland,47,33,38,42,85,75,1.4242424242424243,0.9047619047619048,1.1333333333333333
2006,Switzerland,55,35,43,42,98,77,1.5714285714285714,1.0238095238095237,1.2727272727272727
2010,Switzerland,50,38,37,27,87,65,1.3157894736842106,1.3703703703703705,1.3384615384615384
2014,Switzerland,54,25,41,27,95,52,2.16,1.5185185185185186,1.8269230769230769
2018,Switzerland,69,20,41,34,110,54,3.45,1.2058823529411764,2.037037037037037
2022,Switzerland,62,28,56,52,118,80,2.2142857142857144,1.0769230769230769,1.475
2002,Guernsey,0,0,2,1,2,1,,2.0,2.0
2006,Guernsey,0,0,1,1,1,1,,1.0,1.0
2010,Guernsey,0,0,1,1,1,1,,1.0,1.0
2002,Austria,51,31,22,54,73,85,1.6451612903225807,0.4074074074074074,0.8588235294117647
2006,Austria,55,54,20,30,75,84,1.0185185185185186,0.6666666666666666,0.8928571428571429
2010,Austria,55,60,19,33,74,93,0.9166666666666666,0.5757575757575758,0.7956989247311828
2014,Austria,47,35,37,36,84,71,1.3428571428571427,1.0277777777777777,1.1830985915492958
2018,Austria,50,30,40,24,90,54,1.6666666666666667,1.6666666666666667,1.6666666666666667
2022,Austria,68,36,53,39,121,75,1.8888888888888888,1.358974358974359,1.6133333333333333
2002,Denmark,46,24,58,39,104,63,1.9166666666666667,1.4871794871794872,1.6507936507936507
2006,Denmark,48,31,60,37,108,68,1.5483870967741935,1.6216216216216217,1.588235294117647
2010,Denmark,43,32,41,37,84,69,1.34375,1.1081081081081081,1.2173913043478262
2014,Denmark,51,32,36,42,87,74,1.59375,0.8571428571428571,1.1756756756756757
2018,Denmark,60,17,37,28,97,45,3.5294117647058822,1.3214285714285714,2.1555555555555554
2022,Denmark,83,18,54,38,137,56,4.611111111111111,1.4210526315789473,2.4464285714285716
2002,Barbados,25,25,20,30,45,55,1.0,0.6666666666666666,0.8181818181818182
2006,Barbados,24,20,17,23,41,43,1.2,0.7391304347826086,0.9534883720930233
2010,Barbados,15,11,6,31,21,42,1.3636363636363635,0.1935483870967742,0.5
2014,Barbados,6,12,10,14,16,26,0.5,0.7142857142857143,0.6153846153846154
2018,Barbados,16,13,24,33,40,46,1.2307692307692308,0.7272727272727273,0.8695652173913043
2022,Barbados,23,23,36,74,59,97,1.0,0.4864864864864865,0.6082474226804123
2002,Grenada,40,32,22,23,62,55,1.25,0.9565217391304348,1.1272727272727272
2006,Grenada,24,8,11,23,35,31,3.0,0.4782608695652174,1.1290322580645162
2010,Grenada,23,20,8,44,31,64,1.15,0.18181818181818182,0.484375
2014,Grenada,8,16,6,31,14,47,0.5,0.1935483870967742,0.2978723404255319
2018,Grenada,21,25,8,29,29,54,0.84,0.27586206896551724,0.5370370370370371
2022,Grenada,23,35,18,43,41,78,0.6571428571428571,0.4186046511627907,0.5256410256410257
2002,Martinique,25,17,24,22,49,39,1.4705882352941178,1.0909090909090908,1.2564102564102564
2006,Martinique,15,12,12,17,27,29,1.25,0.7058823529411765,0.9310344827586207
2010,Martinique,8,6,9,6,17,12,1.3333333333333333,1.5,1.4166666666666667
2014,Martinique,5,6,9,7,14,13,0.8333333333333334,1.2857142857142858,1.0769230769230769
2018,Martinique,19,7,15,19,34,26,2.7142857142857144,0.7894736842105263,1.3076923076923077
2022,Martinique,7,6,26,46,33,52,1.1666666666666667,0.5652173913043478,0.6346153846153846
2002,Saint Vincent and the Grenadines,28,17,20,35,48,52,1.6470588235294117,0.5714285714285714,0.9230769230769231
2006,Saint Vincent and the Grenadines,9,9,15,27,24,36,1.0,0.5555555555555556,0.6666666666666666
2010,Saint Vincent and the Grenadines,3,12,11,18,14,30,0.25,0.6111111111111112,0.4666666666666667
2014,Saint Vincent and the Grenadines,9,21,13,35,22,56,0.42857142857142855,0.37142857142857144,0.39285714285714285
2018,Saint Vincent and the Grenadines,14,21,22,40,36,61,0.6666666666666666,0.55,0.5901639344262295
2022,Saint Vincent and the Grenadines,23,24,32,58,55,82,0.9583333333333334,0.5517241379310345,0.6707317073170732
2002,Germany,91,35,58,47,149,82,2.6,1.2340425531914894,1.8170731707317074
2006,Germany,84,32,84,43,168,75,2.625,1.9534883720930232,2.24
2010,Germany,90,38,88,38,178,76,2.3684210526315788,2.3157894736842106,2.3421052631578947
2014,Germany,89,44,87,42,176,86,2.022727272727273,2.0714285714285716,2.046511627906977
2018,Germany,89,38,55,29,144,67,2.3421052631578947,1.896551724137931,2.1492537313432836
2022,Germany,116,51,48,30,164,81,2.2745098039215685,1.6,2.0246913580246915
2002,Israel,51,17,44,56,95,73,3.0,0.7857142857142857,1.3013698630136987
2006,Israel,35,24,37,35,72,59,1.4583333333333333,1.0571428571428572,1.2203389830508475
2010,Israel,44,28,34,38,78,66,1.5714285714285714,0.8947368421052632,1.1818181818181819
2014,Israel,28,32,41,36,69,68,0.875,1.1388888888888888,1.0147058823529411
2018,Israel,34,29,22,39,56,68,1.1724137931034482,0.5641025641025641,0.8235294117647058
2022,Israel,40,30,47,69,87,99,1.3333333333333333,0.6811594202898551,0.8787878787878788
2002,Sweden,48,19,66,32,114,51,2.526315789473684,2.0625,2.235294117647059
2006,Sweden,55,23,67,50,122,73,2.391304347826087,1.34,1.6712328767123288
2010,Sweden,60,22,60,55,120,77,2.727272727272727,1.0909090909090908,1.5584415584415585
2014,Sweden,62,37,58,42,120,79,1.6756756756756757,1.380952380952381,1.518987341772152
2018,Sweden,52,23,52,47,104,70,2.260869565217391,1.1063829787234043,1.4857142857142858
2022,Sweden,60,26,61,58,121,84,2.3076923076923075,1.0517241379310345,1.4404761904761905
2002,Gabon,46,21,30,45,76,66,2.1904761904761907,0.6666666666666666,1.1515151515151516
2006,Gabon,29,6,29,37,58,43,4.833333333333333,0.7837837837837838,1.3488372093023255
2010,Gabon,22,12,35,32,57,44,1.8333333333333333,1.09375,1.2954545454545454
2014,Gabon,29,14,32,46,61,60,2.0714285714285716,0.6956521739130435,1.0166666666666666
2018,Gabon,17,11,30,41,47,52,1.5454545454545454,0.7317073170731707,0.9038461538461539
2022,Gabon,19,8,30,40,49,48,2.375,0.75,1.0208333333333333
2002,Suriname,20,6,7,9,27,15,3.3333333333333335,0.7777777777777778,1.8
2006,Suriname,16,13,15,22,31,35,1.2307692307692308,0.6818181818181818,0.8857142857142857
2010,Suriname,17,17,17,24,34,41,1.0,0.7083333333333334,0.8292682926829268
2014,Suriname,9,11,7,12,16,23,0.8181818181818182,0.5833333333333334,0.6956521739130435
2018,Suriname,18,4,10,11,28,15,4.5,0.9090909090909091,1.8666666666666667
2022,Suriname,40,10,27,29,67,39,4.0,0.9310344827586207,1.7179487179487178
2002,Guadeloupe,6,0,19,17,25,17,,1.1176470588235294,1.4705882352941178
2006,Guadeloupe,9,4,21,17,30,21,2.25,1.2352941176470589,1.4285714285714286
2010,Guadeloupe,8,7,28,28,36,35,1.1428571428571428,1.0,1.0285714285714285
2014,Guadeloupe,5,6,12,9,17,15,0.8333333333333334,1.3333333333333333,1.1333333333333333
2018,Guadeloupe,18,6,9,15,27,21,3.0,0.6,1.2857142857142858
2022,Guadeloupe,32,6,38,25,70,31,5.333333333333333,1.52,2.2580645161290325
2002,Brazil,61,17,106,54,167,71,3.588235294117647,1.962962962962963,2.352112676056338
2006,Brazil,39,9,119,49,158,58,4.333333333333333,2.4285714285714284,2.7241379310344827
2010,Brazil,32,6,119,43,151,49,5.333333333333333,2.7674418604651163,3.0816326530612246
2014,Brazil,49,8,113,41,162,49,6.125,2.7560975609756095,3.306122448979592
2018,Brazil,58,5,80,25,138,30,11.6,3.2,4.6
2022,Brazil,69,9,67,35,136,44,7.666666666666667,1.9142857142857144,3.090909090909091
2002,Cayman Islands,10,25,1,11,11,36,0.4,0.09090909090909091,0.3055555555555556
2006,Cayman Islands,2,7,1,4,3,11,0.2857142857142857,0.25,0.2727272727272727
2010,Cayman Islands,4,15,1,10,5,25,0.26666666666666666,0.1,0.2
2014,Cayman Islands,3,7,0,15,3,22,0.42857142857142855,0.0,0.13636363636363635
2018,Cayman Islands,7,5,2,19,9,24,1.4,0.10526315789473684,0.375
2022,Cayman Islands,13,21,11,42,24,63,0.6190476190476191,0.2619047619047619,0.38095238095238093
2002,Jersey,1,7,0,1,1,8,0.14285714285714285,0.0,0.125
2006,Jersey,3,5,2,4,5,9,0.6,0.5,0.5555555555555556
2010,Jersey,2,1,0,0,2,1,2.0,,2.0
2014,Jersey,0,0,2,0,2,0,,,
2018,Jersey,0,2,2,0,2,2,0.0,,1.0
2002,Andalusia,13,6,0,0,13,6,2.1666666666666665,,2.1666666666666665
2006,Andalusia,9,2,0,0,9,2,4.5,,4.5
2010,Andalusia,4,1,0,0,4,1,4.0,,4.0
2014,Andalusia,0,0,2,1,2,1,,2.0,2.0
2002,Canada,19,12,39,55,58,67,1.5833333333333333,0.7090909090909091,0.8656716417910447
2006,Canada,21,15,47,66,68,81,1.4,0.7121212121212122,0.8395061728395061
2010,Canada,25,13,54,58,79,71,1.9230769230769231,0.9310344827586207,1.1126760563380282
2014,Canada,25,8,35,50,60,58,3.125,0.7,1.0344827586206897
2018,Canada,32,6,59,39,91,45,5.333333333333333,1.5128205128205128,2.022222222222222
2022,Canada,46,11,101,53,147,64,4.181818181818182,1.9056603773584906,2.296875
2002,Dominica,7,5,20,42,27,47,1.4,0.47619047619047616,0.574468085106383
2006,Dominica,1,9,14,34,15,43,0.1111111111111111,0.4117647058823529,0.3488372093023256
2010,Dominica,5,11,4,10,9,21,0.45454545454545453,0.4,0.42857142857142855
2014,Dominica,4,12,0,10,4,22,0.3333333333333333,0.0,0.18181818181818182
2018,Dominica,9,10,5,20,14,30,0.9,0.25,0.4666666666666667
2022,Dominica,13,12,22,42,35,54,1.0833333333333333,0.5238095238095238,0.6481481481481481
2002,Saint Lucia,32,18,37,43,69,61,1.7777777777777777,0.8604651162790697,1.1311475409836065
2006,Saint Lucia,15,6,14,44,29,50,2.5,0.3181818181818182,0.58
2010,Saint Lucia,11,22,7,45,18,67,0.5,0.15555555555555556,0.26865671641791045
2014,Saint Lucia,6,21,9,26,15,47,0.2857142857142857,0.34615384615384615,0.3191489361702128
2018,Saint Lucia,1,3,12,16,13,19,0.3333333333333333,0.75,0.6842105263157895
2022,Saint Lucia,16,17,22,30,38,47,0.9411764705882353,0.7333333333333333,0.8085106382978723
2002,Mauritania,3,6,2,22,5,28,0.5,0.09090909090909091,0.17857142857142858
2006,Mauritania,6,8,4,29,10,37,0.75,0.13793103448275862,0.2702702702702703
2010,Mauritania,4,7,2,17,6,24,0.5714285714285714,0.11764705882352941,0.25
2014,Mauritania,15,7,10,23,25,30,2.142857142857143,0.43478260869565216,0.8333333333333334
2018,Mauritania,27,9,16,46,43,55,3.0,0.34782608695652173,0.7818181818181819
2022,Mauritania,18,12,24,55,42,67,1.5,0.43636363636363634,0.6268656716417911
2002,Zimbabwe,59,24,58,49,117,73,2.4583333333333335,1.183673469387755,1.6027397260273972
2006,Zimbabwe,38,15,57,65,95,80,2.533333333333333,0.8769230769230769,1.1875
2010,Zimbabwe,35,17,25,53,60,70,2.0588235294117645,0.4716981132075472,0.8571428571428571
2014,Zimbabwe,34,13,42,42,76,55,2.6153846153846154,1.0,1.3818181818181818
2018,Zimbabwe,25,6,60,50,85,56,4.166666666666667,1.2,1.5178571428571428
2022,Zimbabwe,8,7,23,36,31,43,1.1428571428571428,0.6388888888888888,0.7209302325581395
2002,Guyana,3,4,4,12,7,16,0.75,0.3333333333333333,0.4375
2006,Guyana,20,11,6,20,26,31,1.8181818181818181,0.3,0.8387096774193549
2010,Guyana,17,19,21,50,38,69,0.8947368421052632,0.42,0.5507246376811594
2014,Guyana,22,18,17,33,39,51,1.2222222222222223,0.5151515151515151,0.7647058823529411
2018,Guyana,22,12,19,21,41,33,1.8333333333333333,0.9047619047619048,1.2424242424242424
2022,Guyana,25,26,50,58,75,84,0.9615384615384616,0.8620689655172413,0.8928571428571429
2002,Wales,27,25,17,31,44,56,1.08,0.5483870967741935,0.7857142857142857
2006,Wales,44,29,24,32,68,61,1.5172413793103448,0.75,1.1147540983606556
2010,Wales,35,30,22,35,57,65,1.1666666666666667,0.6285714285714286,0.8769230769230769
2014,Wales,33,27,24,32,57,59,1.2222222222222223,0.75,0.9661016949152542
2018,Wales,33,18,33,28,66,46,1.8333333333333333,1.1785714285714286,1.434782608695652
2022,Wales,47,20,27,40,74,60,2.35,0.675,1.2333333333333334
2002,Romania,44,23,57,38,101,61,1.9130434782608696,1.5,1.6557377049180328
2006,Romania,63,21,35,28,98,49,3.0,1.25,2.0
2010,Romania,52,26,41,40,93,66,2.0,1.025,1.4090909090909092
2014,Romania,41,20,51,38,92,58,2.05,1.3421052631578947,1.5862068965517242
2018,Romania,40,23,43,41,83,64,1.7391304347826086,1.048780487804878,1.296875
2022,Romania,47,28,50,43,97,71,1.6785714285714286,1.1627906976744187,1.3661971830985915
2002,Turkey,41,24,45,35,86,59,1.7083333333333333,1.2857142857142858,1.4576271186440677
2006,Turkey,33,20,86,63,119,83,1.65,1.3650793650793651,1.4337349397590362
2010,Turkey,39,21,60,55,99,76,1.8571428571428572,1.0909090909090908,1.3026315789473684
2014,Turkey,47,31,50,40,97,71,1.5161290322580645,1.25,1.3661971830985915
2018,Turkey,48,24,43,38,91,62,2.0,1.131578947368421,1.467741935483871
2022,Turkey,64,30,65,62,129,92,2.1333333333333333,1.0483870967741935,1.4021739130434783
2002,Yugoslavia,0,0,0,1,0,1,,0.0,0.0
2002,Antigua and Barbuda,9,4,17,40,26,44,2.25,0.425,0.5909090909090909
2006,Antigua and Barbuda,22,6,13,34,35,40,3.6666666666666665,0.38235294117647056,0.875
2010,Antigua and Barbuda,43,19,26,32,69,51,2.263157894736842,0.8125,1.3529411764705883
2014,Antigua and Barbuda,31,18,15,18,46,36,1.7222222222222223,0.8333333333333334,1.2777777777777777
2018,Antigua and Barbuda,19,17,16,32,35,49,1.1176470588235294,0.5,0.7142857142857143
2022,Antigua and Barbuda,15,21,21,65,36,86,0.7142857142857143,0.3230769230769231,0.4186046511627907
2002,Curaçao,12,2,8,21,20,23,6.0,0.38095238095238093,0.8695652173913043
2006,Curaçao,13,4,8,12,21,16,3.25,0.6666666666666666,1.3125
2010,Curaçao,10,8,14,22,24,30,1.25,0.6363636363636364,0.8
2014,Curaçao,11,8,12,17,23,25,1.375,0.7058823529411765,0.92
2018,Curaçao,24,6,15,19,39,25,4.0,0.7894736842105263,1.56
2022,Curaçao,24,13,34,38,58,51,1.8461538461538463,0.8947368421052632,1.1372549019607843
2002,Georgia,30,25,18,37,48,62,1.2,0.4864864864864865,0.7741935483870968
2006,Georgia,31,32,29,60,60,92,0.96875,0.48333333333333334,0.6521739130434783
2010,Georgia,20,18,29,56,49,74,1.1111111111111112,0.5178571428571429,0.6621621621621622
2014,Georgia,20,18,25,52,45,70,1.1111111111111112,0.4807692307692308,0.6428571428571429
2018,Georgia,41,20,31,49,72,69,2.05,0.6326530612244898,1.0434782608695652
2022,Georgia,45,25,42,57,87,82,1.8,0.7368421052631579,1.0609756097560976
2002,Burkina Faso,51,26,42,78,93,104,1.9615384615384615,0.5384615384615384,0.8942307692307693
2006,Burkina Faso,31,11,31,60,62,71,2.8181818181818183,0.5166666666666667,0.8732394366197183
2010,Burkina Faso,27,16,36,51,63,67,1.6875,0.7058823529411765,0.9402985074626866
2014,Burkina Faso,31,13,49,56,80,69,2.3846153846153846,0.875,1.1594202898550725
2018,Burkina Faso,25,7,41,43,66,50,3.5714285714285716,0.9534883720930233,1.32
2022,Burkina Faso,5,1,74,57,79,58,5.0,1.2982456140350878,1.3620689655172413
2002,French Guiana,1,2,5,6,6,8,0.5,0.8333333333333334,0.75
2006,French Guiana,2,3,7,10,9,13,0.6666666666666666,0.7,0.6923076923076923
2010,French Guiana,7,10,11,13,18,23,0.7,0.8461538461538461,0.782608695652174
2014,French Guiana,9,10,2,7,11,17,0.9,0.2857142857142857,0.6470588235294118
2018,French Guiana,16,7,12,22,28,29,2.2857142857142856,0.5454545454545454,0.9655172413793104
2022,French Guiana,12,8,31,30,43,38,1.5,1.0333333333333334,1.131578947368421
2002,Iceland,32,18,29,57,61,75,1.7777777777777777,0.5087719298245614,0.8133333333333334
2006,Iceland,31,32,25,59,56,91,0.96875,0.423728813559322,0.6153846153846154
2010,Iceland,35,29,24,50,59,79,1.206896551724138,0.48,0.7468354430379747
2014,Iceland,31,14,59,79,90,93,2.2142857142857144,0.7468354430379747,0.967741935483871
2018,Iceland,34,24,70,85,104,109,1.4166666666666667,0.8235294117647058,0.9541284403669725
2022,Iceland,34,31,55,83,89,114,1.096774193548387,0.6626506024096386,0.7807017543859649
2002,Italy,53,20,40,27,93,47,2.65,1.4814814814814814,1.9787234042553192
2006,Italy,55,16,55,39,110,55,3.4375,1.4102564102564104,2.0
2010,Italy,49,12,55,48,104,60,4.083333333333333,1.1458333333333333,1.7333333333333334
2014,Italy,45,24,59,46,104,70,1.875,1.2826086956521738,1.4857142857142858
2018,Italy,67,17,56,32,123,49,3.9411764705882355,1.75,2.510204081632653
2022,Italy,89,23,60,35,149,58,3.869565217391304,1.7142857142857142,2.5689655172413794
2002,Liechtenstein,8,39,11,74,19,113,0.20512820512820512,0.14864864864864866,0.168141592920354
2006,Liechtenstein,18,47,12,72,30,119,0.3829787234042553,0.16666666666666666,0.25210084033613445
2010,Liechtenstein,11,44,10,69,21,113,0.25,0.14492753623188406,0.18584070796460178
2014,Liechtenstein,12,49,7,71,19,120,0.24489795918367346,0.09859154929577464,0.15833333333333333
2018,Liechtenstein,7,51,15,78,22,129,0.13725490196078433,0.19230769230769232,0.17054263565891473
2022,Liechtenstein,4,47,13,100,17,147,0.0851063829787234,0.13,0.11564625850340136
2002,Jordan,44,29,59,44,103,73,1.5172413793103448,1.3409090909090908,1.4109589041095891
2006,Jordan,48,22,55,57,103,79,2.1818181818181817,0.9649122807017544,1.3037974683544304
2010,Jordan,59,31,51,69,110,100,1.903225806451613,0.7391304347826086,1.1
2014,Jordan,70,26,61,75,131,101,2.6923076923076925,0.8133333333333334,1.297029702970297
2018,Jordan,57,13,44,43,101,56,4.384615384615385,1.0232558139534884,1.8035714285714286
2022,Jordan,39,15,74,58,113,73,2.6,1.2758620689655173,1.547945205479452
2002,Tunisia,84,34,30,34,114,68,2.4705882352941178,0.8823529411764706,1.6764705882352942
2006,Tunisia,74,30,40,28,114,58,2.466666666666667,1.4285714285714286,1.9655172413793103
2010,Tunisia,56,22,61,44,117,66,2.5454545454545454,1.3863636363636365,1.7727272727272727
2014,Tunisia,58,17,52,52,110,69,3.411764705882353,1.0,1.5942028985507246
2018,Tunisia,45,12,51,46,96,58,3.75,1.108695652173913,1.6551724137931034
2022,Tunisia,48,7,39,33,87,40,6.857142857142857,1.1818181818181819,2.175
2002,Norway,46,26,51,32,97,58,1.7692307692307692,1.59375,1.6724137931034482
2006,Norway,40,31,52,46,92,77,1.2903225806451613,1.1304347826086956,1.1948051948051948
2010,Norway,48,27,33,34,81,61,1.7777777777777777,0.9705882352941176,1.3278688524590163
2014,Norway,35,26,30,53,65,79,1.3461538461538463,0.5660377358490566,0.8227848101265823
2018,Norway,46,21,35,43,81,64,2.1904761904761907,0.813953488372093,1.265625
2022,Norway,71,26,42,38,113,64,2.730769230769231,1.105263157894737,1.765625
2002,Namibia,25,31,18,61,43,92,0.8064516129032258,0.29508196721311475,0.4673913043478261
2006,Namibia,21,22,24,53,45,75,0.9545454545454546,0.4528301886792453,0.6
2010,Namibia,24,18,28,53,52,71,1.3333333333333333,0.5283018867924528,0.7323943661971831
2014,Namibia,20,18,31,32,51,50,1.1111111111111112,0.96875,1.02
2018,Namibia,21,16,30,37,51,53,1.3125,0.8108108108108109,0.9622641509433962
2022,Namibia,7,6,41,57,48,63,1.1666666666666667,0.7192982456140351,0.7619047619047619
2002,Argentina,41,13,90,49,131,62,3.1538461538461537,1.836734693877551,2.1129032258064515
2006,Argentina,30,12,97,57,127,69,2.5,1.7017543859649122,1.8405797101449275
2010,Argentina,74,22,73,53,147,75,3.3636363636363638,1.3773584905660377,1.96
2014,Argentina,57,15,105,48,162,63,3.8,2.1875,2.5714285714285716
2018,Argentina,29,7,97,44,126,51,4.142857142857143,2.2045454545454546,2.4705882352941178
2022,Argentina,40,5,100,31,140,36,8.0,3.225806451612903,3.888888888888889
2002,Uruguay,36,18,68,77,104,95,2.0,0.8831168831168831,1.0947368421052632
2006,Uruguay,37,15,80,83,117,98,2.466666666666667,0.963855421686747,1.1938775510204083
2010,Uruguay,44,20,76,60,120,80,2.2,1.2666666666666666,1.5
2014,Uruguay,50,15,60,55,110,70,3.3333333333333335,1.0909090909090908,1.5714285714285714
2018,Uruguay,35,11,48,45,83,56,3.1818181818181817,1.0666666666666667,1.4821428571428572
2022,Uruguay,38,11,59,41,97,52,3.4545454545454546,1.4390243902439024,1.8653846153846154
2002,China PR,83,23,63,30,146,53,3.608695652173913,2.1,2.7547169811320753
2006,China PR,73,32,41,53,114,85,2.28125,0.7735849056603774,1.3411764705882352
2010,China PR,86,43,57,55,143,98,2.0,1.0363636363636364,1.4591836734693877
2014,China PR,85,36,47,46,132,82,2.361111111111111,1.0217391304347827,1.6097560975609757
2018,China PR,57,31,49,37,106,68,1.8387096774193548,1.3243243243243243,1.5588235294117647
2022,China PR,39,16,45,54,84,70,2.4375,0.8333333333333334,1.2
2002,Japan,36,20,73,42,109,62,1.8,1.7380952380952381,1.7580645161290323
2006,Japan,82,25,78,46,160,71,3.28,1.6956521739130435,2.2535211267605635
2010,Japan,87,23,65,45,152,68,3.782608695652174,1.4444444444444444,2.235294117647059
2014,Japan,81,19,76,45,157,64,4.2631578947368425,1.6888888888888889,2.453125
2018,Japan,39,12,70,37,109,49,3.25,1.8918918918918919,2.2244897959183674
2022,Japan,102,13,87,33,189,46,7.846153846153846,2.6363636363636362,4.108695652173913
2002,Trinidad and Tobago,69,36,60,82,129,118,1.9166666666666667,0.7317073170731707,1.0932203389830508
2006,Trinidad and Tobago,80,35,51,90,131,125,2.2857142857142856,0.5666666666666667,1.048
2010,Trinidad and Tobago,55,22,38,56,93,78,2.5,0.6785714285714286,1.1923076923076923
2014,Trinidad and Tobago,22,10,35,56,57,66,2.2,0.625,0.8636363636363636
2018,Trinidad and Tobago,37,19,28,70,65,89,1.9473684210526316,0.4,0.7303370786516854
2022,Trinidad and Tobago,49,15,43,72,92,87,3.2666666666666666,0.5972222222222222,1.0574712643678161
2002,Faroe Islands,21,36,15,45,36,81,0.5833333333333334,0.3333333333333333,0.4444444444444444
2006,Faroe Islands,13,45,15,74,28,119,0.28888888888888886,0.20270270270270271,0.23529411764705882
2010,Faroe Islands,9,31,13,72,22,103,0.2903225806451613,0.18055555555555555,0.21359223300970873
2014,Faroe Islands,9,33,15,45,24,78,0.2727272727272727,0.3333333333333333,0.3076923076923077
2018,Faroe Islands,16,36,18,47,34,83,0.4444444444444444,0.3829787234042553,0.40963855421686746
2022,Faroe Islands,24,43,22,63,46,106,0.5581395348837209,0.3492063492063492,0.4339622641509434
2002,Réunion,0,0,2,2,2,2,,1.0,1.0
2006,Réunion,4,6,3,5,7,11,0.6666666666666666,0.6,0.6363636363636364
2010,Réunion,0,3,8,6,8,9,0.0,1.3333333333333333,0.8888888888888888
2014,Réunion,0,0,7,3,7,3,,2.3333333333333335,2.3333333333333335
2002,New Zealand,42,6,40,37,82,43,7.0,1.0810810810810811,1.9069767441860466
2006,New Zealand,10,2,33,40,43,42,5.0,0.825,1.0238095238095237
2010,New Zealand,20,8,37,49,57,57,2.5,0.7551020408163265,1.0
2014,New Zealand,17,9,37,37,54,46,1.8888888888888888,1.0,1.173913043478261
2018,New Zealand,10,1,18,16,28,17,10.0,1.125,1.6470588235294117
2022,New Zealand,22,4,47,24,69,28,5.5,1.9583333333333333,2.4642857142857144
2002,Sudan,43,24,32,54,75,78,1.7916666666666667,0.5925925925925926,0.9615384615384616
2006,Sudan,55,33,53,76,108,109,1.6666666666666667,0.6973684210526315,0.9908256880733946
2010,Sudan,33,28,45,76,78,104,1.1785714285714286,0.5921052631578947,0.75
2014,Sudan,14,22,44,64,58,86,0.6363636363636364,0.6875,0.6744186046511628
2018,Sudan,10,12,18,30,28,42,0.8333333333333334,0.6,0.6666666666666666
2022,Sudan,13,10,34,44,47,54,1.3,0.7727272727272727,0.8703703703703703
2002,Guinea,24,4,25,36,49,40,6.0,0.6944444444444444,1.225
2006,Guinea,30,7,65,61,95,68,4.285714285714286,1.0655737704918034,1.3970588235294117
2010,Guinea,25,11,61,64,86,75,2.272727272727273,0.953125,1.1466666666666667
2014,Guinea,17,7,53,59,70,66,2.4285714285714284,0.8983050847457628,1.0606060606060606
2018,Guinea,13,10,40,53,53,63,1.3,0.7547169811320755,0.8412698412698413
2022,Guinea,4,1,57,70,61,71,4.0,0.8142857142857143,0.8591549295774648
2002,DR Congo,39,18,39,56,78,74,2.1666666666666665,0.6964285714285714,1.054054054054054
2006,DR Congo,35,15,47,61,82,76,2.3333333333333335,0.7704918032786885,1.0789473684210527
2010,DR Congo,33,13,42,50,75,63,2.5384615384615383,0.84,1.1904761904761905
2014,DR Congo,40,14,57,47,97,61,2.857142857142857,1.2127659574468086,1.5901639344262295
2018,DR Congo,27,13,62,58,89,71,2.076923076923077,1.0689655172413792,1.2535211267605635
2022,DR Congo,17,6,43,45,60,51,2.8333333333333335,0.9555555555555556,1.1764705882352942
2002,Madagascar,22,17,15,47,37,64,1.2941176470588236,0.3191489361702128,0.578125
2006,Madagascar,15,14,22,55,37,69,1.0714285714285714,0.4,0.5362318840579711
2010,Madagascar,16,19,22,39,38,58,0.8421052631578947,0.5641025641025641,0.6551724137931034
2014,Madagascar,14,20,19,31,33,51,0.7,0.6129032258064516,0.6470588235294118
2018,Madagascar,18,19,50,46,68,65,0.9473684210526315,1.0869565217391304,1.0461538461538462
2022,Madagascar,5,7,38,55,43,62,0.7142857142857143,0.6909090909090909,0.6935483870967742
2002,Mauritius,17,16,18,43,35,59,1.0625,0.4186046511627907,0.5932203389830508
2006,Mauritius,13,21,14,55,27,76,0.6190476190476191,0.2545454545454545,0.35526315789473684
2010,Mauritius,7,24,4,49,11,73,0.2916666666666667,0.08163265306122448,0.1506849315068493
2014,Mauritius,8,16,9,35,17,51,0.5,0.2571428571428571,0.3333333333333333
2018,Mauritius,9,15,20,56,29,71,0.6,0.35714285714285715,0.4084507042253521
2022,Mauritius,10,10,10,29,20,39,1.0,0.3448275862068966,0.5128205128205128
2002,Mali,43,24,35,31,78,55,1.7916666666666667,1.1290322580645162,1.4181818181818182
2006,Mali,30,10,53,42,83,52,3.0,1.2619047619047619,1.5961538461538463
2010,Mali,29,8,61,57,90,65,3.625,1.0701754385964912,1.3846153846153846
2014,Mali,26,8,54,62,80,70,3.25,0.8709677419354839,1.1428571428571428
2018,Mali,18,5,45,44,63,49,3.6,1.0227272727272727,1.2857142857142858
2022,Mali,34,10,53,26,87,36,3.4,2.0384615384615383,2.4166666666666665
2002,Finland,41,26,42,50,83,76,1.5769230769230769,0.84,1.0921052631578947
2006,Finland,39,31,37,44,76,75,1.2580645161290323,0.8409090909090909,1.0133333333333334
2010,Finland,33,22,33,53,66,75,1.5,0.6226415094339622,0.88
2014,Finland,15,20,40,56,55,76,0.75,0.7142857142857143,0.7236842105263158
2018,Finland,30,14,34,52,64,66,2.142857142857143,0.6538461538461539,0.9696969696969697
2022,Finland,38,23,41,66,79,89,1.6521739130434783,0.6212121212121212,0.8876404494382022
2002,Portugal,116,34,53,25,169,59,3.411764705882353,2.12,2.864406779661017
2006,Portugal,99,30,51,36,150,66,3.3,1.4166666666666667,2.272727272727273
2010,Portugal,69,22,58,38,127,60,3.1363636363636362,1.5263157894736843,2.1166666666666667
2014,Portugal,72,24,63,37,135,61,3.0,1.7027027027027026,2.2131147540983607
2018,Portugal,86,20,55,26,141,46,4.3,2.1153846153846154,3.0652173913043477
2022,Portugal,101,20,65,27,166,47,5.05,2.4074074074074074,3.5319148936170213
2002,Seychelles,4,9,2,17,6,26,0.4444444444444444,0.11764705882352941,0.23076923076923078
2006,Seychelles,13,22,13,38,26,60,0.5909090909090909,0.34210526315789475,0.43333333333333335
2010,Seychelles,5,19,13,42,18,61,0.2631578947368421,0.30952380952380953,0.29508196721311475
2014,Seychelles,12,15,5,45,17,60,0.8,0.1111111111111111,0.2833333333333333
2018,Seychelles,4,19,9,65,13,84,0.21052631578947367,0.13846153846153847,0.15476190476190477
2022,Seychelles,0,4,11,74,11,78,0.0,0.14864864864864866,0.14102564102564102
2002,Sierra Leone,16,7,3,21,19,28,2.2857142857142856,0.14285714285714285,0.6785714285714286
2006,Sierra Leone,12,6,4,26,16,32,2.0,0.15384615384615385,0.5
2010,Sierra Leone,15,11,11,38,26,49,1.3636363636363635,0.2894736842105263,0.5306122448979592
2014,Sierra Leone,21,10,15,41,36,51,2.1,0.36585365853658536,0.7058823529411765
2018,Sierra Leone,4,1,10,21,14,22,4.0,0.47619047619047616,0.6363636363636364
2022,Sierra Leone,2,1,38,61,40,62,2.0,0.6229508196721312,0.6451612903225806
2002,Tanzania,23,27,18,47,41,74,0.8518518518518519,0.3829787234042553,0.5540540540540541
2006,Tanzania,25,16,29,51,54,67,1.5625,0.5686274509803921,0.8059701492537313
2010,Tanzania,41,38,50,53,91,91,1.0789473684210527,0.9433962264150944,1.0
2014,Tanzania,34,29,43,65,77,94,1.1724137931034482,0.6615384615384615,0.8191489361702128
2018,Tanzania,22,12,25,60,47,72,1.8333333333333333,0.4166666666666667,0.6527777777777778
2022,Tanzania,18,21,19,31,37,52,0.8571428571428571,0.6129032258064516,0.7115384615384616
2002,Ghana,51,21,28,46,79,67,2.4285714285714284,0.6086956521739131,1.1791044776119404
2006,Ghana,47,13,50,48,97,61,3.6153846153846154,1.0416666666666667,1.5901639344262295
2010,Ghana,46,11,60,57,106,68,4.181818181818182,1.0526315789473684,1.5588235294117647
2014,Ghana,50,11,78,56,128,67,4.545454545454546,1.3928571428571428,1.9104477611940298
2018,Ghana,30,7,50,36,80,43,4.285714285714286,1.3888888888888888,1.8604651162790697
2022,Ghana,30,9,32,45,62,54,3.3333333333333335,0.7111111111111111,1.1481481481481481
2002,Congo,27,17,27,50,54,67,1.588235294117647,0.54,0.8059701492537313
2006,Congo,21,12,8,31,29,43,1.75,0.25806451612903225,0.6744186046511628
2010,Congo,15,9,23,41,38,50,1.6666666666666667,0.5609756097560976,0.76
2014,Congo,23,20,37,44,60,64,1.15,0.8409090909090909,0.9375
2018,Congo,23,21,24,36,47,57,1.0952380952380953,0.6666666666666666,0.8245614035087719
2022,Congo,12,11,15,47,27,58,1.0909090909090908,0.3191489361702128,0.46551724137931033
2002,Chad,8,3,15,23,23,26,2.6666666666666665,0.6521739130434783,0.8846153846153846
2006,Chad,9,10,10,28,19,38,0.9,0.35714285714285715,0.5
2010,Chad,13,19,11,38,24,57,0.6842105263157895,0.2894736842105263,0.42105263157894735
2014,Chad,11,8,4,23,15,31,1.375,0.17391304347826086,0.4838709677419355
2018,Chad,5,6,3,14,8,20,0.8333333333333334,0.21428571428571427,0.4
2022,Chad,3,9,7,26,10,35,0.3333333333333333,0.2692307692307692,0.2857142857142857
2002,Malaysia,57,35,58,83,115,118,1.6285714285714286,0.6987951807228916,0.9745762711864406
2006,Malaysia,38,39,25,52,63,91,0.9743589743589743,0.4807692307692308,0.6923076923076923
2010,Malaysia,55,41,38,61,93,102,1.3414634146341464,0.6229508196721312,0.9117647058823529
2014,Malaysia,49,38,40,86,89,124,1.2894736842105263,0.46511627906976744,0.717741935483871
2018,Malaysia,65,31,28,59,93,90,2.096774193548387,0.4745762711864407,1.0333333333333334
2022,Malaysia,86,21,34,61,120,82,4.095238095238095,0.5573770491803278,1.4634146341463414
2002,Singapore,52,51,32,44,84,95,1.0196078431372548,0.7272727272727273,0.8842105263157894
2006,Singapore,66,48,51,53,117,101,1.375,0.9622641509433962,1.1584158415841583
2010,Singapore,66,54,49,59,115,113,1.2222222222222223,0.8305084745762712,1.0176991150442478
2014,Singapore,57,45,36,75,93,120,1.2666666666666666,0.48,0.775
2018,Singapore,42,39,19,45,61,84,1.0769230769230769,0.4222222222222222,0.7261904761904762
2022,Singapore,50,54,25,54,75,108,0.9259259259259259,0.46296296296296297,0.6944444444444444
2002,Yemen,19,19,44,54,63,73,1.0,0.8148148148148148,0.863013698630137
2006,Yemen,26,26,26,51,52,77,1.0,0.5098039215686274,0.6753246753246753
2010,Yemen,32,20,17,39,49,59,1.6,0.4358974358974359,0.8305084745762712
2014,Yemen,1,2,22,65,23,67,0.5,0.3384615384615385,0.34328358208955223
2018,Yemen,0,0,26,57,26,57,,0.45614035087719296,0.45614035087719296
2022,Yemen,0,0,21,51,21,51,,0.4117647058823529,0.4117647058823529
2002,Saudi Arabia,112,28,54,32,166,60,4.0,1.6875,2.7666666666666666
2006,Saudi Arabia,125,37,47,41,172,78,3.3783783783783785,1.146341463414634,2.2051282051282053
2010,Saudi Arabia,66,22,50,49,116,71,3.0,1.0204081632653061,1.6338028169014085
2014,Saudi Arabia,45,15,48,51,93,66,3.0,0.9411764705882353,1.4090909090909092
2018,Saudi Arabia,47,21,61,53,108,74,2.238095238095238,1.150943396226415,1.4594594594594594
2022,Saudi Arabia,44,18,40,36,84,54,2.4444444444444446,1.1111111111111112,1.5555555555555556
2002,Pakistan,0,2,20,75,20,77,0.0,0.26666666666666666,0.2597402597402597
2006,Pakistan,8,24,29,53,37,77,0.3333333333333333,0.5471698113207547,0.4805194805194805
2010,Pakistan,0,7,34,43,34,50,0.0,0.7906976744186046,0.68
2014,Pakistan,2,3,13,39,15,42,0.6666666666666666,0.3333333333333333,0.35714285714285715
2018,Pakistan,2,1,9,16,11,17,2.0,0.5625,0.6470588235294118
2022,Pakistan,2,12,1,29,3,41,0.16666666666666666,0.034482758620689655,0.07317073170731707
2002,Hong Kong,47,19,17,44,64,63,2.473684210526316,0.38636363636363635,1.0158730158730158
2006,Hong Kong,59,17,64,53,123,70,3.4705882352941178,1.2075471698113207,1.7571428571428571
2010,Hong Kong,25,35,43,41,68,76,0.7142857142857143,1.048780487804878,0.8947368421052632
2014,Hong Kong,48,43,10,28,58,71,1.1162790697674418,0.35714285714285715,0.8169014084507042
2018,Hong Kong,41,19,17,33,58,52,2.1578947368421053,0.5151515151515151,1.1153846153846154
2022,Hong Kong,40,16,12,63,52,79,2.5,0.19047619047619047,0.6582278481012658
2002,Bangladesh,11,5,25,42,36,47,2.2,0.5952380952380952,0.7659574468085106
2006,Bangladesh,17,22,15,32,32,54,0.7727272727272727,0.46875,0.5925925925925926
2010,Bangladesh,17,5,12,39,29,44,3.4,0.3076923076923077,0.6590909090909091
2014,Bangladesh,17,19,21,74,38,93,0.8947368421052632,0.28378378378378377,0.40860215053763443
2018,Bangladesh,21,24,12,59,33,83,0.875,0.2033898305084746,0.39759036144578314
2022,Bangladesh,15,12,23,60,38,72,1.25,0.38333333333333336,0.5277777777777778
2002,North Korea,9,6,22,32,31,38,1.5,0.6875,0.8157894736842105
2006,North Korea,18,11,81,41,99,52,1.6363636363636365,1.975609756097561,1.9038461538461537
2010,North Korea,13,2,118,54,131,56,6.5,2.185185185185185,2.3392857142857144
2014,North Korea,9,3,75,47,84,50,3.0,1.5957446808510638,1.68
2018,North Korea,13,4,48,66,61,70,3.25,0.7272727272727273,0.8714285714285714
2022,North Korea,2,0,20,36,22,36,,0.5555555555555556,0.6111111111111112
2002,Aruba,6,9,4,26,10,35,0.6666666666666666,0.15384615384615385,0.2857142857142857
2006,Aruba,1,5,2,15,3,20,0.2,0.13333333333333333,0.15
2010,Aruba,4,8,2,5,6,13,0.5,0.4,0.46153846153846156
2014,Aruba,10,7,5,6,15,13,1.4285714285714286,0.8333333333333334,1.1538461538461537
2018,Aruba,2,3,13,26,15,29,0.6666666666666666,0.5,0.5172413793103449
2022,Aruba,12,12,24,60,36,72,1.0,0.4,0.5
2002,Benin,27,16,13,54,40,70,1.6875,0.24074074074074073,0.5714285714285714
2006,Benin,34,18,28,83,62,101,1.8888888888888888,0.3373493975903614,0.6138613861386139
2010,Benin,22,15,33,57,55,72,1.4666666666666666,0.5789473684210527,0.7638888888888888
2014,Benin,19,15,20,38,39,53,1.2666666666666666,0.5263157894736842,0.7358490566037735
2018,Benin,20,10,26,31,46,41,2.0,0.8387096774193549,1.1219512195121952
2022,Benin,13,11,40,40,53,51,1.1818181818181819,1.0,1.0392156862745099
2002,Niger,8,6,1,23,9,29,1.3333333333333333,0.043478260869565216,0.3103448275862069
2006,Niger,9,9,7,32,16,41,1.0,0.21875,0.3902439024390244
2010,Niger,26,16,8,42,34,58,1.625,0.19047619047619047,0.5862068965517241
2014,Niger,35,22,10,54,45,76,1.5909090909090908,0.18518518518518517,0.5921052631578947
2018,Niger,25,23,6,26,31,49,1.0869565217391304,0.23076923076923078,0.6326530612244898
2022,Niger,15,16,25,61,40,77,0.9375,0.4098360655737705,0.5194805194805194
2002,Croatia,42,21,35,33,77,54,2.0,1.0606060606060606,1.4259259259259258
2006,Croatia,59,21,66,44,125,65,2.8095238095238093,1.5,1.9230769230769231
2010,Croatia,57,26,57,33,114,59,2.1923076923076925,1.7272727272727273,1.9322033898305084
2014,Croatia,66,19,52,31,118,50,3.473684210526316,1.6774193548387097,2.36
2018,Croatia,61,21,45,47,106,68,2.9047619047619047,0.9574468085106383,1.5588235294117647
2022,Croatia,46,24,62,49,108,73,1.9166666666666667,1.2653061224489797,1.4794520547945205
2002,Fiji,51,9,51,29,102,38,5.666666666666667,1.7586206896551724,2.6842105263157894
2006,Fiji,41,8,51,23,92,31,5.125,2.217391304347826,2.967741935483871
2010,Fiji,16,8,50,15,66,23,2.0,3.3333333333333335,2.869565217391304
2014,Fiji,21,4,27,16,48,20,5.25,1.6875,2.4
2018,Fiji,21,9,53,30,74,39,2.3333333333333335,1.7666666666666666,1.8974358974358974
2022,Fiji,21,6,55,31,76,37,3.5,1.7741935483870968,2.054054054054054
2002,Vanuatu,2,4,75,60,77,64,0.5,1.25,1.203125
2006,Vanuatu,6,8,77,35,83,43,0.75,2.2,1.930232558139535
2010,Vanuatu,6,4,62,40,68,44,1.5,1.55,1.5454545454545454
2014,Vanuatu,5,2,32,27,37,29,2.5,1.1851851851851851,1.2758620689655173
2018,Vanuatu,28,10,29,19,57,29,2.8,1.5263157894736843,1.9655172413793103
2022,Vanuatu,9,9,39,32,48,41,1.0,1.21875,1.170731707317073
2002,New Caledonia,4,1,82,34,86,35,4.0,2.411764705882353,2.4571428571428573
2006,New Caledonia,13,8,59,15,72,23,1.625,3.933333333333333,3.130434782608696
2010,New Caledonia,57,20,46,21,103,41,2.85,2.1904761904761907,2.5121951219512195
2014,New Caledonia,46,14,46,18,92,32,3.2857142857142856,2.5555555555555554,2.875
2018,New Caledonia,4,4,51,29,55,33,1.0,1.7586206896551724,1.6666666666666667
2022,New Caledonia,0,0,53,24,53,24,,2.2083333333333335,2.2083333333333335
2002,Solomon Islands,15,6,69,59,84,65,2.5,1.1694915254237288,1.2923076923076924
2006,Solomon Islands,19,11,55,34,74,45,1.7272727272727273,1.6176470588235294,1.6444444444444444
2010,Solomon Islands,14,16,45,25,59,41,0.875,1.8,1.4390243902439024
2014,Solomon Islands,14,19,24,28,38,47,0.7368421052631579,0.8571428571428571,0.8085106382978723
2018,Solomon Islands,11,9,61,34,72,43,1.2222222222222223,1.7941176470588236,1.6744186046511629
2022,Solomon Islands,21,6,52,35,73,41,3.5,1.4857142857142858,1.7804878048780488
2002,Bulgaria,47,22,38,48,85,70,2.1363636363636362,0.7916666666666666,1.2142857142857142
2006,Bulgaria,45,20,37,43,82,63,2.25,0.8604651162790697,1.3015873015873016
2010,Bulgaria,27,17,29,44,56,61,1.588235294117647,0.6590909090909091,0.9180327868852459
2014,Bulgaria,23,18,21,40,44,58,1.2777777777777777,0.525,0.7586206896551724
2018,Bulgaria,28,30,17,38,45,68,0.9333333333333333,0.4473684210526316,0.6617647058823529
2022,Bulgaria,31,40,19,48,50,88,0.775,0.3958333333333333,0.5681818181818182
2002,Cyprus,30,34,13,55,43,89,0.8823529411764706,0.23636363636363636,0.48314606741573035
2006,Cyprus,35,32,13,47,48,79,1.09375,0.2765957446808511,0.6075949367088608
2010,Cyprus,32,39,15,42,47,81,0.8205128205128205,0.35714285714285715,0.5802469135802469
2014,Cyprus,19,35,12,35,31,70,0.5428571428571428,0.34285714285714286,0.44285714285714284
2018,Cyprus,25,34,21,54,46,88,0.7352941176470589,0.3888888888888889,0.5227272727272727
2022,Cyprus,22,49,27,78,49,127,0.4489795918367347,0.34615384615384615,0.3858267716535433
2002,San Marino,2,37,4,74,6,111,0.05405405405405406,0.05405405405405406,0.05405405405405406
2006,San Marino,6,63,2,75,8,138,0.09523809523809523,0.02666666666666667,0.057971014492753624
2010,San Marino,5,56,0,97,5,153,0.08928571428571429,0.0,0.032679738562091505
2014,San Marino,3,69,2,85,5,154,0.043478260869565216,0.023529411764705882,0.032467532467532464
2018,San Marino,1,63,3,111,4,174,0.015873015873015872,0.02702702702702703,0.022988505747126436
2022,San Marino,9,73,6,109,15,182,0.1232876712328767,0.05504587155963303,0.08241758241758242
2002,Albania,30,22,20,45,50,67,1.3636363636363635,0.4444444444444444,0.746268656716418
2006,Albania,35,25,29,47,64,72,1.4,0.6170212765957447,0.8888888888888888
2010,Albania,39,25,13,36,52,61,1.56,0.3611111111111111,0.8524590163934426
2014,Albania,31,30,30,34,61,64,1.0333333333333334,0.8823529411764706,0.953125
2018,Albania,28,33,34,38,62,71,0.8484848484848485,0.8947368421052632,0.8732394366197183
2022,Albania,38,25,37,42,75,67,1.52,0.8809523809523809,1.1194029850746268
2002,Ethiopia,25,13,27,37,52,50,1.9230769230769231,0.7297297297297297,1.04
2006,Ethiopia,31,12,25,19,56,31,2.5833333333333335,1.3157894736842106,1.8064516129032258
2010,Ethiopia,23,18,25,41,48,59,1.2777777777777777,0.6097560975609756,0.8135593220338984
2014,Ethiopia,45,30,34,69,79,99,1.5,0.4927536231884058,0.797979797979798
2018,Ethiopia,26,21,15,33,41,54,1.2380952380952381,0.45454545454545453,0.7592592592592593
2022,Ethiopia,27,15,19,41,46,56,1.8,0.4634146341463415,0.8214285714285714
2002,Guatemala,34,25,50,61,84,86,1.36,0.819672131147541,0.9767441860465116
2006,Guatemala,34,15,55,88,89,103,2.2666666666666666,0.625,0.8640776699029126
2010,Guatemala,33,12,55,59,88,71,2.75,0.9322033898305084,1.2394366197183098
2014,Guatemala,36,17,37,60,73,77,2.1176470588235294,0.6166666666666667,0.948051948051948
2018,Guatemala,44,6,23,45,67,51,7.333333333333333,0.5111111111111111,1.3137254901960784
2022,Guatemala,62,5,54,54,116,59,12.4,1.0,1.9661016949152543
2002,Zanzibar,0,1,13,29,13,30,0.0,0.4482758620689655,0.43333333333333335
2006,Zanzibar,2,2,23,34,25,36,1.0,0.6764705882352942,0.6944444444444444
2010,Zanzibar,2,1,28,23,30,24,2.0,1.2173913043478262,1.25
2014,Zanzibar,0,0,16,22,16,22,,0.7272727272727273,0.7272727272727273
2018,Zanzibar,0,0,12,12,12,12,,1.0,1.0
2002,Kenya,46,20,74,75,120,95,2.3,0.9866666666666667,1.263157894736842
2006,Kenya,40,16,39,59,79,75,2.5,0.6610169491525424,1.0533333333333332
2010,Kenya,36,22,41,67,77,89,1.6363636363636365,0.6119402985074627,0.8651685393258427
2014,Kenya,34,16,40,48,74,64,2.125,0.8333333333333334,1.15625
2018,Kenya,29,16,27,33,56,49,1.8125,0.8181818181818182,1.1428571428571428
2022,Kenya,12,10,25,34,37,44,1.2,0.7352941176470589,0.8409090909090909
2002,Central African Republic,2,6,16,18,18,24,0.3333333333333333,0.8888888888888888,0.75
2006,Central African Republic,0,3,1,3,1,6,0.0,0.3333333333333333,0.16666666666666666
2010,Central African Republic,8,2,6,19,14,21,4.0,0.3157894736842105,0.6666666666666666
2014,Central African Republic,13,3,14,50,27,53,4.333333333333333,0.28,0.5094339622641509
2018,Central African Republic,11,2,18,40,29,42,5.5,0.45,0.6904761904761905
2022,Central African Republic,2,1,29,57,31,58,2.0,0.5087719298245614,0.5344827586206896
2002,India,24,16,44,47,68,63,1.5,0.9361702127659575,1.0793650793650793
2006,India,28,31,41,57,69,88,0.9032258064516129,0.7192982456140351,0.7840909090909091
2010,India,48,30,27,69,75,99,1.6,0.391304347826087,0.7575757575757576
2014,India,57,35,31,62,88,97,1.6285714285714286,0.5,0.9072164948453608
2018,India,40,21,27,26,67,47,1.9047619047619047,1.0384615384615385,1.425531914893617
2022,India,20,12,25,39,45,51,1.6666666666666667,0.6410256410256411,0.8823529411764706
2002,Australia,102,10,76,25,178,35,10.2,3.04,5.085714285714285
2006,Australia,57,13,55,30,112,43,4.384615384615385,1.8333333333333333,2.604651162790698
2010,Australia,39,11,84,44,123,55,3.5454545454545454,1.9090909090909092,2.2363636363636363
2014,Australia,66,14,84,62,150,76,4.714285714285714,1.3548387096774193,1.9736842105263157
2018,Australia,60,17,52,26,112,43,3.5294117647058822,2.0,2.604651162790698
2022,Australia,36,7,65,27,101,34,5.142857142857143,2.4074074074074074,2.9705882352941178
2002,Guinea-Bissau,1,2,0,5,1,7,0.5,0.0,0.14285714285714285
2006,Guinea-Bissau,1,2,0,3,1,5,0.5,0.0,0.2
2010,Guinea-Bissau,2,5,9,12,11,17,0.4,0.75,0.6470588235294118
2014,Guinea-Bissau,12,16,10,12,22,28,0.75,0.8333333333333334,0.7857142857142857
2018,Guinea-Bissau,17,15,9,27,26,42,1.1333333333333333,0.3333333333333333,0.6190476190476191
2022,Guinea-Bissau,15,7,30,53,45,60,2.142857142857143,0.5660377358490566,0.75
2010,Alderney,1,1,0,0,1,1,1.0,,1.0
2014,Alderney,1,1,2,11,3,12,1.0,0.18181818181818182,0.25
2018,Alderney,0,0,1,9,1,9,,0.1111111111111111,0.1111111111111111
2002,Nicaragua,7,6,7,37,14,43,1.1666666666666667,0.1891891891891892,0.32558139534883723
2006,Nicaragua,7,4,4,19,11,23,1.75,0.21052631578947367,0.4782608695652174
2010,Nicaragua,7,4,7,29,14,33,1.75,0.2413793103448276,0.42424242424242425
2014,Nicaragua,22,11,16,19,38,30,2.0,0.8421052631578947,1.2666666666666666
2018,Nicaragua,26,22,29,40,55,62,1.1818181818181819,0.725,0.8870967741935484
2022,Nicaragua,43,19,44,50,87,69,2.263157894736842,0.88,1.2608695652173914
2002,Puerto Rico,2,4,2,10,4,14,0.5,0.2,0.2857142857142857
2006,Puerto Rico,6,7,3,4,9,11,0.8571428571428571,0.75,0.8181818181818182
2010,Puerto Rico,18,12,4,9,22,21,1.5,0.4444444444444444,1.0476190476190477
2014,Puerto Rico,15,11,2,16,17,27,1.3636363636363635,0.125,0.6296296296296297
2018,Puerto Rico,5,11,4,24,9,35,0.45454545454545453,0.16666666666666666,0.2571428571428571
2022,Puerto Rico,44,21,32,30,76,51,2.0952380952380953,1.0666666666666667,1.4901960784313726
2002,Dominican Republic,21,5,5,18,26,23,4.2,0.2777777777777778,1.1304347826086956
2006,Dominican Republic,7,6,3,22,10,28,1.1666666666666667,0.13636363636363635,0.35714285714285715
2010,Dominican Republic,15,7,6,15,21,22,2.142857142857143,0.4,0.9545454545454546
2014,Dominican Republic,29,13,6,10,35,23,2.230769230769231,0.6,1.5217391304347827
2018,Dominican Republic,27,9,9,13,36,22,3.0,0.6923076923076923,1.6363636363636365
2022,Dominican Republic,41,20,32,29,73,49,2.05,1.103448275862069,1.489795918367347
2002,Panama,37,12,20,61,57,73,3.0833333333333335,0.32786885245901637,0.7808219178082192
2006,Panama,28,23,38,72,66,95,1.2173913043478262,0.5277777777777778,0.6947368421052632
2010,Panama,44,23,51,55,95,78,1.9130434782608696,0.9272727272727272,1.2179487179487178
2014,Panama,49,21,56,63,105,84,2.3333333333333335,0.8888888888888888,1.25
2018,Panama,20,17,50,76,70,93,1.1764705882352942,0.6578947368421053,0.7526881720430108
2022,Panama,50,17,75,96,125,113,2.9411764705882355,0.78125,1.1061946902654867
2002,Anguilla,1,3,7,21,8,24,0.3333333333333333,0.3333333333333333,0.3333333333333333
2006,Anguilla,0,0,0,22,0,22,,0.0,0.0
2010,Anguilla,1,3,1,25,2,28,0.3333333333333333,0.04,0.07142857142857142
2014,Anguilla,0,3,0,14,0,17,0.0,0.0,0.0
2018,Anguilla,3,21,4,44,7,65,0.14285714285714285,0.09090909090909091,0.1076923076923077
2022,Anguilla,3,26,5,77,8,103,0.11538461538461539,0.06493506493506493,0.07766990291262135
2002,Honduras,60,24,82,67,142,91,2.5,1.2238805970149254,1.5604395604395604
2006,Honduras,38,18,71,61,109,79,2.111111111111111,1.1639344262295082,1.379746835443038
2010,Honduras,56,23,68,70,124,93,2.4347826086956523,0.9714285714285714,1.3333333333333333
2014,Honduras,38,21,47,69,85,90,1.8095238095238095,0.6811594202898551,0.9444444444444444
2018,Honduras,35,14,36,62,71,76,2.5,0.5806451612903226,0.9342105263157895
2022,Honduras,38,22,47,76,85,98,1.7272727272727273,0.618421052631579,0.8673469387755102
2002,Chile,36,25,38,64,74,89,1.44,0.59375,0.8314606741573034
2006,Chile,43,21,37,62,80,83,2.0476190476190474,0.5967741935483871,0.963855421686747
2010,Chile,55,21,62,76,117,97,2.619047619047619,0.8157894736842105,1.2061855670103092
2014,Chile,70,27,69,64,139,91,2.5925925925925926,1.078125,1.5274725274725274
2018,Chile,51,25,53,58,104,83,2.04,0.9137931034482759,1.2530120481927711
2022,Chile,37,20,35,63,72,83,1.85,0.5555555555555556,0.8674698795180723
2002,Peru,41,33,44,60,85,93,1.2424242424242424,0.7333333333333333,0.9139784946236559
2006,Peru,46,33,35,75,81,108,1.393939393939394,0.4666666666666667,0.75
2010,Peru,27,20,36,74,63,94,1.35,0.4864864864864865,0.6702127659574468
2014,Peru,38,24,53,67,91,91,1.5833333333333333,0.7910447761194029,1.0
2018,Peru,34,31,54,48,88,79,1.096774193548387,1.125,1.1139240506329113
2022,Peru,29,22,34,60,63,82,1.3181818181818181,0.5666666666666667,0.7682926829268293
2002,Bolivia,35,16,21,78,56,94,2.1875,0.2692307692307692,0.5957446808510638
2006,Bolivia,33,17,22,69,55,86,1.9411764705882353,0.3188405797101449,0.6395348837209303
2010,Bolivia,36,27,21,74,57,101,1.3333333333333333,0.28378378378378377,0.5643564356435643
2014,Bolivia,29,34,21,94,50,128,0.8529411764705882,0.22340425531914893,0.390625
2018,Bolivia,23,22,24,95,47,117,1.0454545454545454,0.25263157894736843,0.4017094017094017
2022,Bolivia,38,26,21,103,59,129,1.4615384615384615,0.20388349514563106,0.4573643410852713
2002,Paraguay,45,23,44,58,89,81,1.9565217391304348,0.7586206896551724,1.0987654320987654
2006,Paraguay,30,8,57,73,87,81,3.75,0.7808219178082192,1.0740740740740742
2010,Paraguay,31,13,67,78,98,91,2.3846153846153846,0.8589743589743589,1.0769230769230769
2014,Paraguay,33,27,48,77,81,104,1.2222222222222223,0.6233766233766234,0.7788461538461539
2018,Paraguay,19,20,35,59,54,79,0.95,0.5932203389830508,0.6835443037974683
2022,Paraguay,21,15,34,61,55,76,1.4,0.5573770491803278,0.7236842105263158
2002,Ecuador,36,16,54,82,90,98,2.25,0.6585365853658537,0.9183673469387755
2006,Ecuador,51,14,47,106,98,120,3.642857142857143,0.44339622641509435,0.8166666666666667
2010,Ecuador,50,15,46,78,96,93,3.3333333333333335,0.5897435897435898,1.032258064516129
2014,Ecuador,49,13,58,67,107,80,3.769230769230769,0.8656716417910447,1.3375
2018,Ecuador,42,18,50,57,92,75,2.3333333333333335,0.8771929824561403,1.2266666666666666
2022,Ecuador,35,9,48,60,83,69,3.888888888888889,0.8,1.2028985507246377
2002,Slovenia,44,28,40,43,84,71,1.5714285714285714,0.9302325581395349,1.1830985915492958
2006,Slovenia,37,41,18,32,55,73,0.9024390243902439,0.5625,0.7534246575342466
2010,Slovenia,48,34,23,25,71,59,1.411764705882353,0.92,1.2033898305084745
2014,Slovenia,31,25,27,32,58,57,1.24,0.84375,1.0175438596491229
2018,Slovenia,38,19,26,27,64,46,2.0,0.9629629629629629,1.391304347826087
2022,Slovenia,53,25,42,36,95,61,2.12,1.1666666666666667,1.5573770491803278
2002,Philippines,1,1,13,103,14,104,1.0,0.1262135922330097,0.1346153846153846
2006,Philippines,13,2,16,33,29,35,6.5,0.48484848484848486,0.8285714285714286
2010,Philippines,31,6,43,54,74,60,5.166666666666667,0.7962962962962963,1.2333333333333334
2014,Philippines,68,31,50,51,118,82,2.193548387096774,0.9803921568627451,1.4390243902439024
2018,Philippines,29,32,29,45,58,77,0.90625,0.6444444444444445,0.7532467532467533
2022,Philippines,18,23,34,58,52,81,0.782608695652174,0.5862068965517241,0.6419753086419753
2018,Ynys Môn,7,2,0,0,7,2,3.5,,3.5
2022,Ynys Môn,7,2,0,0,7,2,3.5,,3.5
2002,Åland Islands,2,2,0,0,2,2,1.0,,1.0
2006,Åland Islands,2,2,0,0,2,2,1.0,,1.0
2002,Moldova,12,18,16,58,28,76,0.6666666666666666,0.27586206896551724,0.3684210526315789
2006,Moldova,25,22,16,55,41,77,1.1363636363636365,0.2909090909090909,0.5324675324675324
2010,Moldova,17,24,36,59,53,83,0.7083333333333334,0.6101694915254238,0.6385542168674698
2014,Moldova,16,31,32,59,48,90,0.5161290322580645,0.5423728813559322,0.5333333333333333
2018,Moldova,10,38,15,62,25,100,0.2631578947368421,0.24193548387096775,0.25
2022,Moldova,27,57,19,65,46,122,0.47368421052631576,0.2923076923076923,0.3770491803278688
2002,Guam,7,1,0,100,7,101,7.0,0.0,0.06930693069306931
2006,Guam,9,0,14,142,23,142,,0.09859154929577464,0.1619718309859155
2010,Guam,28,4,24,115,52,119,7.0,0.20869565217391303,0.4369747899159664
2014,Guam,24,8,17,76,41,84,3.0,0.2236842105263158,0.4880952380952381
2018,Guam,9,12,10,38,19,50,0.75,0.2631578947368421,0.38
2022,Guam,6,6,5,42,11,48,1.0,0.11904761904761904,0.22916666666666666
2002,Papua New Guinea,3,5,55,46,58,51,0.6,1.1956521739130435,1.1372549019607843
2006,Papua New Guinea,3,5,30,15,33,20,0.6,2.0,1.65
2010,Papua New Guinea,0,0,25,10,25,10,,2.5,2.5
2014,Papua New Guinea,13,4,27,27,40,31,3.25,1.0,1.2903225806451613
2018,Papua New Guinea,15,9,23,17,38,26,1.6666666666666667,1.3529411764705883,1.4615384615384615
2022,Papua New Guinea,4,5,36,31,40,36,0.8,1.1612903225806452,1.1111111111111112
2002,Lithuania,14,31,21,59,35,90,0.45161290322580644,0.3559322033898305,0.3888888888888889
2006,Lithuania,22,15,35,55,57,70,1.4666666666666666,0.6363636363636364,0.8142857142857143
2010,Lithuania,24,18,24,51,48,69,1.3333333333333333,0.47058823529411764,0.6956521739130435
2014,Lithuania,20,20,17,54,37,74,1.0,0.3148148148148148,0.5
2018,Lithuania,18,37,13,67,31,104,0.4864864864864865,0.19402985074626866,0.2980769230769231
2022,Lithuania,23,50,16,54,39,104,0.46,0.2962962962962963,0.375
2002,Estonia,37,37,41,73,78,110,1.0,0.5616438356164384,0.7090909090909091
2006,Estonia,39,42,23,70,62,112,0.9285714285714286,0.32857142857142857,0.5535714285714286
2010,Estonia,38,42,26,84,64,126,0.9047619047619048,0.30952380952380953,0.5079365079365079
2014,Estonia,40,31,25,81,65,112,1.2903225806451613,0.30864197530864196,0.5803571428571429
2018,Estonia,33,37,27,64,60,101,0.8918918918918919,0.421875,0.594059405940594
2022,Estonia,19,45,23,78,42,123,0.4222222222222222,0.2948717948717949,0.34146341463414637
2002,Cape Verde,13,7,8,15,21,22,1.8571428571428572,0.5333333333333333,0.9545454545454546
2006,Cape Verde,21,16,14,37,35,53,1.3125,0.3783783783783784,0.660377358490566
2010,Cape Verde,25,11,17,24,42,35,2.272727272727273,0.7083333333333334,1.2
2014,Cape Verde,31,13,28,35,59,48,2.3846153846153846,0.8,1.2291666666666667
2018,Cape Verde,18,12,21,24,39,36,1.5,0.875,1.0833333333333333
2022,Cape Verde,18,11,39,37,57,48,1.6363636363636365,1.054054054054054,1.1875
2002,El Salvador,28,24,30,82,58,106,1.1666666666666667,0.36585365853658536,0.5471698113207547
2006,El Salvador,33,22,28,68,61,90,1.5,0.4117647058823529,0.6777777777777778
2010,El Salvador,52,23,61,82,113,105,2.260869565217391,0.7439024390243902,1.0761904761904761
2014,El Salvador,27,16,47,72,74,88,1.6875,0.6527777777777778,0.8409090909090909
2018,El Salvador,20,6,29,56,49,62,3.3333333333333335,0.5178571428571429,0.7903225806451613
2022,El Salvador,26,12,60,79,86,91,2.1666666666666665,0.759493670886076,0.945054945054945
2002,Sri Lanka,23,16,23,91,46,107,1.4375,0.25274725274725274,0.42990654205607476
2006,Sri Lanka,17,12,27,61,44,73,1.4166666666666667,0.4426229508196721,0.6027397260273972
2010,Sri Lanka,20,20,30,50,50,70,1.0,0.6,0.7142857142857143
2014,Sri Lanka,3,6,24,71,27,77,0.5,0.3380281690140845,0.35064935064935066
2018,Sri Lanka,4,11,11,52,15,63,0.36363636363636365,0.21153846153846154,0.23809523809523808
2022,Sri Lanka,4,7,11,56,15,63,0.5714285714285714,0.19642857142857142,0.23809523809523808
2002,Maldives,29,17,33,90,62,107,1.7058823529411764,0.36666666666666664,0.5794392523364486
2006,Maldives,29,15,27,34,56,49,1.9333333333333333,0.7941176470588235,1.1428571428571428
2010,Maldives,31,13,19,32,50,45,2.3846153846153846,0.59375,1.1111111111111112
2014,Maldives,36,20,45,61,81,81,1.8,0.7377049180327869,1.0
2018,Maldives,25,22,31,62,56,84,1.1363636363636365,0.5,0.6666666666666666
2022,Maldives,12,13,17,34,29,47,0.9230769230769231,0.5,0.6170212765957447
2002,Ukraine,28,19,29,35,57,54,1.4736842105263157,0.8285714285714286,1.0555555555555556
2006,Ukraine,50,20,28,29,78,49,2.5,0.9655172413793104,1.5918367346938775
2010,Ukraine,51,35,36,35,87,70,1.457142857142857,1.0285714285714285,1.2428571428571429
2014,Ukraine,50,26,54,30,104,56,1.9230769230769231,1.8,1.8571428571428572
2018,Ukraine,38,13,41,50,79,63,2.923076923076923,0.82,1.253968253968254
2022,Ukraine,28,12,69,71,97,83,2.3333333333333335,0.971830985915493,1.1686746987951808
2002,Cuba,24,10,34,38,58,48,2.4,0.8947368421052632,1.2083333333333333
2006,Cuba,20,10,30,61,50,71,2.0,0.4918032786885246,0.704225352112676
2010,Cuba,13,16,14,59,27,75,0.8125,0.23728813559322035,0.36
2014,Cuba,6,14,12,73,18,87,0.42857142857142855,0.1643835616438356,0.20689655172413793
2018,Cuba,18,3,14,76,32,79,6.0,0.18421052631578946,0.4050632911392405
2022,Cuba,23,4,31,87,54,91,5.75,0.3563218390804598,0.5934065934065934
2002,Haiti,23,13,58,76,81,89,1.7692307692307692,0.7631578947368421,0.9101123595505618
2006,Haiti,9,14,59,64,68,78,0.6428571428571429,0.921875,0.8717948717948718
2010,Haiti,15,9,43,54,58,63,1.6666666666666667,0.7962962962962963,0.9206349206349206
2014,Haiti,13,5,31,46,44,51,2.6,0.6739130434782609,0.8627450980392157
2018,Haiti,20,5,27,39,47,44,4.0,0.6923076923076923,1.0681818181818181
2022,Haiti,7,4,104,56,111,60,1.75,1.8571428571428572,1.85
2002,Kazakhstan,14,8,29,34,43,42,1.75,0.8529411764705882,1.0238095238095237
2006,Kazakhstan,27,35,13,62,40,97,0.7714285714285715,0.20967741935483872,0.41237113402061853
2010,Kazakhstan,30,39,16,60,46,99,0.7692307692307693,0.26666666666666666,0.46464646464646464
2014,Kazakhstan,27,27,21,57,48,84,1.0,0.3684210526315789,0.5714285714285714
2018,Kazakhstan,23,30,25,48,48,78,0.7666666666666667,0.5208333333333334,0.6153846153846154
2022,Kazakhstan,27,32,30,67,57,99,0.84375,0.44776119402985076,0.5757575757575758
2002,Macau,2,8,7,44,9,52,0.25,0.1590909090909091,0.17307692307692307
2006,Macau,4,28,13,43,17,71,0.14285714285714285,0.3023255813953488,0.23943661971830985
2010,Macau,9,33,22,60,31,93,0.2727272727272727,0.36666666666666664,0.3333333333333333
2014,Macau,7,12,23,44,30,56,0.5833333333333334,0.5227272727272727,0.5357142857142857
2018,Macau,9,17,18,27,27,44,0.5294117647058824,0.6666666666666666,0.6136363636363636
2022,Macau,1,3,2,19,3,22,0.3333333333333333,0.10526315789473684,0.13636363636363635
2002,Tajikistan,10,7,24,17,34,24,1.4285714285714286,1.411764705882353,1.4166666666666667
2006,Tajikistan,16,6,45,45,61,51,2.6666666666666665,1.0,1.196078431372549
2010,Tajikistan,13,10,45,55,58,65,1.3,0.8181818181818182,0.8923076923076924
2014,Tajikistan,34,22,35,51,69,73,1.5454545454545454,0.6862745098039216,0.9452054794520548
2018,Tajikistan,28,21,20,39,48,60,1.3333333333333333,0.5128205128205128,0.8
2022,Tajikistan,17,7,37,40,54,47,2.4285714285714284,0.925,1.148936170212766
2002,Uzbekistan,55,11,63,66,118,77,5.0,0.9545454545454546,1.5324675324675325
2006,Uzbekistan,55,14,65,53,120,67,3.9285714285714284,1.2264150943396226,1.791044776119403
2010,Uzbekistan,43,10,73,78,116,88,4.3,0.9358974358974359,1.3181818181818181
2014,Uzbekistan,43,15,69,60,112,75,2.8666666666666667,1.15,1.4933333333333334
2018,Uzbekistan,40,12,42,51,82,63,3.3333333333333335,0.8235294117647058,1.3015873015873016
2022,Uzbekistan,50,12,61,41,111,53,4.166666666666667,1.4878048780487805,2.0943396226415096
2002,South Africa,50,15,57,55,107,70,3.3333333333333335,1.0363636363636364,1.5285714285714285
2006,South Africa,57,33,47,57,104,90,1.7272727272727273,0.8245614035087719,1.1555555555555554
2010,South Africa,75,28,24,32,99,60,2.6785714285714284,0.75,1.65
2014,South Africa,44,23,60,37,104,60,1.9130434782608696,1.6216216216216217,1.7333333333333334
2018,South Africa,49,25,44,33,93,58,1.96,1.3333333333333333,1.603448275862069
2022,South Africa,65,28,24,29,89,57,2.3214285714285716,0.8275862068965517,1.5614035087719298
2002,Latvia,20,35,35,45,55,80,0.5714285714285714,0.7777777777777778,0.6875
2006,Latvia,31,29,34,52,65,81,1.0689655172413792,0.6538461538461539,0.8024691358024691
2010,Latvia,22,25,35,50,57,75,0.88,0.7,0.76
2014,Latvia,18,29,26,52,44,81,0.6206896551724138,0.5,0.5432098765432098
2018,Latvia,13,40,31,46,44,86,0.325,0.6739130434782609,0.5116279069767442
2022,Latvia,18,37,36,60,54,97,0.4864864864864865,0.6,0.5567010309278351
2002,Turkmenistan,21,2,40,39,61,41,10.5,1.0256410256410255,1.4878048780487805
2006,Turkmenistan,29,8,24,44,53,52,3.625,0.5454545454545454,1.0192307692307692
2010,Turkmenistan,9,7,50,43,59,50,1.2857142857142858,1.1627906976744187,1.18
2014,Turkmenistan,7,4,34,38,41,42,1.75,0.8947368421052632,0.9761904761904762
2018,Turkmenistan,16,10,16,38,32,48,1.6,0.42105263157894735,0.6666666666666666
2022,Turkmenistan,6,7,18,47,24,54,0.8571428571428571,0.3829787234042553,0.4444444444444444
2002,Libya,59,31,21,39,80,70,1.903225806451613,0.5384615384615384,1.1428571428571428
2006,Libya,61,25,24,54,85,79,2.44,0.4444444444444444,1.0759493670886076
2010,Libya,35,15,24,26,59,41,2.3333333333333335,0.9230769230769231,1.4390243902439024
2014,Libya,12,3,44,42,56,45,4.0,1.0476190476190477,1.2444444444444445
2018,Libya,0,0,45,47,45,47,,0.9574468085106383,0.9574468085106383
2022,Libya,13,16,34,40,47,56,0.8125,0.85,0.8392857142857143
2002,Burundi,2,6,43,53,45,59,0.3333333333333333,0.8113207547169812,0.7627118644067796
2006,Burundi,5,8,32,49,37,57,0.625,0.6530612244897959,0.6491228070175439
2010,Burundi,10,10,37,43,47,53,1.0,0.8604651162790697,0.8867924528301887
2014,Burundi,18,14,32,32,50,46,1.2857142857142858,1.0,1.0869565217391304
2018,Burundi,24,15,28,35,52,50,1.6,0.8,1.04
2022,Burundi,7,8,36,52,43,60,0.875,0.6923076923076923,0.7166666666666667
2002,Syria,79,21,48,66,127,87,3.761904761904762,0.7272727272727273,1.4597701149425288
2006,Syria,47,25,71,84,118,109,1.88,0.8452380952380952,1.0825688073394495
2010,Syria,25,11,76,78,101,89,2.272727272727273,0.9743589743589743,1.1348314606741574
2014,Syria,0,0,71,59,71,59,,1.2033898305084745,1.2033898305084745
2018,Syria,0,0,86,69,86,69,,1.2463768115942029,1.2463768115942029
2022,Syria,0,0,64,84,64,84,,0.7619047619047619,0.7619047619047619
2002,Tahiti,0,2,56,50,56,52,0.0,1.12,1.0769230769230769
2006,Tahiti,0,0,34,38,34,38,,0.8947368421052632,0.8947368421052632
2010,Tahiti,2,3,50,31,52,34,0.6666666666666666,1.6129032258064515,1.5294117647058822
2014,Tahiti,2,3,60,30,62,33,0.6666666666666666,2.0,1.878787878787879
2018,Tahiti,5,5,33,14,38,19,1.0,2.357142857142857,2.0
2022,Tahiti,14,4,40,25,54,29,3.5,1.6,1.8620689655172413
2002,Kyrgyzstan,7,5,14,44,21,49,1.4,0.3181818181818182,0.42857142857142855
2006,Kyrgyzstan,11,7,13,32,24,39,1.5714285714285714,0.40625,0.6153846153846154
2010,Kyrgyzstan,4,5,9,38,13,43,0.8,0.23684210526315788,0.3023255813953488
2014,Kyrgyzstan,14,13,18,49,32,62,1.0769230769230769,0.3673469387755102,0.5161290322580645
2018,Kyrgyzstan,26,14,36,35,62,49,1.8571428571428572,1.0285714285714285,1.2653061224489797
2022,Kyrgyzstan,28,21,36,48,64,69,1.3333333333333333,0.75,0.927536231884058
2002,Armenia,13,29,14,36,27,65,0.4482758620689655,0.3888888888888889,0.4153846153846154
2006,Armenia,8,20,19,53,27,73,0.4,0.3584905660377358,0.3698630136986301
2010,Armenia,32,29,26,45,58,74,1.103448275862069,0.5777777777777777,0.7837837837837838
2014,Armenia,21,31,43,55,64,86,0.6774193548387096,0.7818181818181819,0.7441860465116279
2018,Armenia,37,37,37,51,74,88,1.0,0.7254901960784313,0.8409090909090909
2022,Armenia,32,42,33,74,65,116,0.7619047619047619,0.44594594594594594,0.5603448275862069
2002,Belarus,23,22,32,48,55,70,1.0454545454545454,0.6666666666666666,0.7857142857142857
2006,Belarus,34,33,38,52,72,85,1.0303030303030303,0.7307692307692307,0.8470588235294118
2010,Belarus,29,28,45,42,74,70,1.0357142857142858,1.0714285714285714,1.0571428571428572
2014,Belarus,28,25,34,46,62,71,1.12,0.7391304347826086,0.8732394366197183
2018,Belarus,19,18,34,62,53,80,1.0555555555555556,0.5483870967741935,0.6625
2022,Belarus,12,16,35,81,47,97,0.75,0.43209876543209874,0.4845360824742268
2002,Venezuela,48,41,29,80,77,121,1.170731707317073,0.3625,0.6363636363636364
2006,Venezuela,74,56,29,57,103,113,1.3214285714285714,0.5087719298245614,0.911504424778761
2010,Venezuela,70,58,49,76,119,134,1.206896551724138,0.6447368421052632,0.8880597014925373
2014,Venezuela,30,34,48,82,78,116,0.8823529411764706,0.5853658536585366,0.6724137931034483
2018,Venezuela,20,21,42,58,62,79,0.9523809523809523,0.7241379310344828,0.7848101265822784
2022,Venezuela,23,16,45,60,68,76,1.4375,0.75,0.8947368421052632
2002,Lebanon,43,35,36,42,79,77,1.2285714285714286,0.8571428571428571,1.025974025974026
2006,Lebanon,22,20,29,62,51,82,1.1,0.46774193548387094,0.6219512195121951
2010,Lebanon,31,36,20,63,51,99,0.8611111111111112,0.31746031746031744,0.5151515151515151
2014,Lebanon,51,49,23,59,74,108,1.0408163265306123,0.3898305084745763,0.6851851851851852
2018,Lebanon,28,15,23,28,51,43,1.8666666666666667,0.8214285714285714,1.186046511627907
2022,Lebanon,4,9,40,56,44,65,0.4444444444444444,0.7142857142857143,0.676923076923077
2002,Slovakia,48,26,29,38,77,64,1.8461538461538463,0.7631578947368421,1.203125
2006,Slovakia,61,33,43,38,104,71,1.8484848484848484,1.131578947368421,1.4647887323943662
2010,Slovakia,45,35,37,42,82,77,1.2857142857142858,0.8809523809523809,1.0649350649350648
2014,Slovakia,34,20,43,38,77,58,1.7,1.131578947368421,1.3275862068965518
2018,Slovakia,48,23,40,41,88,64,2.0869565217391304,0.975609756097561,1.375
2022,Slovakia,42,29,53,44,95,73,1.4482758620689655,1.2045454545454546,1.3013698630136987
2002,Vietnam,42,14,72,58,114,72,3.0,1.2413793103448276,1.5833333333333333
2006,Vietnam,40,25,27,37,67,62,1.6,0.7297297297297297,1.0806451612903225
2010,Vietnam,39,25,37,43,76,68,1.56,0.8604651162790697,1.1176470588235294
2014,Vietnam,54,31,33,36,87,67,1.7419354838709677,0.9166666666666666,1.2985074626865671
2018,Vietnam,35,15,38,27,73,42,2.3333333333333335,1.4074074074074074,1.7380952380952381
2022,Vietnam,43,20,52,56,95,76,2.15,0.9285714285714286,1.25
2002,Mongolia,0,1,11,64,11,65,0.0,0.171875,0.16923076923076924
2006,Mongolia,1,5,17,51,18,56,0.2,0.3333333333333333,0.32142857142857145
2010,Mongolia,7,6,12,23,19,29,1.1666666666666667,0.5217391304347826,0.6551724137931034
2014,Mongolia,6,1,23,23,29,24,6.0,1.0,1.2083333333333333
2018,Mongolia,21,7,31,45,52,52,3.0,0.6888888888888889,1.0
2022,Mongolia,10,7,5,48,15,55,1.4285714285714286,0.10416666666666667,0.2727272727272727
2002,Azerbaijan,17,16,19,70,36,86,1.0625,0.2714285714285714,0.4186046511627907
2006,Azerbaijan,14,25,26,76,40,101,0.56,0.34210526315789475,0.39603960396039606
2010,Azerbaijan,19,39,34,66,53,105,0.48717948717948717,0.5151515151515151,0.5047619047619047
2014,Azerbaijan,24,23,21,53,45,76,1.0434782608695652,0.39622641509433965,0.5921052631578947
2018,Azerbaijan,23,27,23,46,46,73,0.8518518518518519,0.5,0.6301369863013698
2022,Azerbaijan,21,37,28,61,49,98,0.5675675675675675,0.45901639344262296,0.5
2002,Laos,5,16,17,135,22,151,0.3125,0.1259259259259259,0.1456953642384106
2006,Laos,3,16,28,91,31,107,0.1875,0.3076923076923077,0.2897196261682243
2010,Laos,18,13,29,87,47,100,1.3846153846153846,0.3333333333333333,0.47
2014,Laos,32,41,43,102,75,143,0.7804878048780488,0.4215686274509804,0.5244755244755245
2018,Laos,12,36,30,75,42,111,0.3333333333333333,0.4,0.3783783783783784
2022,Laos,10,20,12,36,22,56,0.5,0.3333333333333333,0.39285714285714285
2002,Myanmar,1,1,53,75,54,76,1.0,0.7066666666666667,0.7105263157894737
2006,Myanmar,8,3,48,78,56,81,2.6666666666666665,0.6153846153846154,0.691358024691358
2010,Myanmar,19,13,39,70,58,83,1.4615384615384615,0.5571428571428572,0.6987951807228916
2014,Myanmar,26,23,31,72,57,95,1.1304347826086956,0.4305555555555556,0.6
2018,Myanmar,23,27,30,70,53,97,0.8518518518518519,0.42857142857142855,0.5463917525773195
2022,Myanmar,22,29,20,108,42,137,0.7586206896551724,0.18518518518518517,0.30656934306569344
2002,Taiwan,4,6,20,68,24,74,0.6666666666666666,0.29411764705882354,0.32432432432432434
2006,Taiwan,10,11,31,71,41,82,0.9090909090909091,0.43661971830985913,0.5
2010,Taiwan,9,7,20,45,29,52,1.2857142857142858,0.4444444444444444,0.5576923076923077
2014,Taiwan,6,10,23,63,29,73,0.6,0.36507936507936506,0.3972602739726027
2018,Taiwan,29,30,16,44,45,74,0.9666666666666667,0.36363636363636365,0.6081081081081081
2022,Taiwan,16,22,22,51,38,73,0.7272727272727273,0.43137254901960786,0.5205479452054794
2002,Gibraltar,5,0,2,2,7,2,,1.0,3.5
2006,Gibraltar,4,0,1,2,5,2,,0.5,2.5
2010,Gibraltar,3,0,1,2,4,2,,0.5,2.0
2014,Gibraltar,4,11,6,83,10,94,0.36363636363636365,0.07228915662650602,0.10638297872340426
2018,Gibraltar,10,32,7,118,17,150,0.3125,0.059322033898305086,0.11333333333333333
2022,Gibraltar,16,45,6,115,22,160,0.35555555555555557,0.05217391304347826,0.1375
2002,Greenland,0,0,4,1,4,1,,4.0,4.0
2002,Tonga,0,0,28,78,28,78,,0.358974358974359,0.358974358974359
2006,Tonga,0,0,17,37,17,37,,0.4594594594594595,0.4594594594594595
2010,Tonga,2,3,10,14,12,17,0.6666666666666666,0.7142857142857143,0.7058823529411765
2014,Tonga,1,8,4,9,5,17,0.125,0.4444444444444444,0.29411764705882354
2018,Tonga,1,8,5,54,6,62,0.125,0.09259259259259259,0.0967741935483871
2022,Tonga,1,5,11,42,12,47,0.2,0.2619047619047619,0.2553191489361702
2002,Nepal,16,9,26,94,42,103,1.7777777777777777,0.2765957446808511,0.4077669902912621
2006,Nepal,6,7,25,80,31,87,0.8571428571428571,0.3125,0.3563218390804598
2010,Nepal,21,19,19,41,40,60,1.105263157894737,0.4634146341463415,0.6666666666666666
2014,Nepal,24,18,16,37,40,55,1.3333333333333333,0.43243243243243246,0.7272727272727273
2018,Nepal,1,2,25,50,26,52,0.5,0.5,0.5
2022,Nepal,11,8,20,87,31,95,1.375,0.22988505747126436,0.3263157894736842
2002,North Macedonia,37,37,28,54,65,91,1.0,0.5185185185185185,0.7142857142857143
2006,North Macedonia,25,26,33,43,58,69,0.9615384615384616,0.7674418604651163,0.8405797101449275
2010,North Macedonia,31,22,26,42,57,64,1.4090909090909092,0.6190476190476191,0.890625
2014,North Macedonia,30,35,13,46,43,81,0.8571428571428571,0.2826086956521739,0.5308641975308642
2018,North Macedonia,44,32,25,28,69,60,1.375,0.8928571428571429,1.15
2022,North Macedonia,47,32,43,53,90,85,1.46875,0.8113207547169812,1.0588235294117647
2002,Czech Republic,84,18,52,35,136,53,4.666666666666667,1.4857142857142858,2.5660377358490565
2006,Czech Republic,77,21,69,36,146,57,3.6666666666666665,1.9166666666666667,2.56140350877193
2010,Czech Republic,46,15,48,43,94,58,3.066666666666667,1.1162790697674418,1.6206896551724137
2014,Czech Republic,39,28,55,48,94,76,1.3928571428571428,1.1458333333333333,1.236842105263158
2018,Czech Republic,41,25,51,53,92,78,1.64,0.9622641509433962,1.1794871794871795
2022,Czech Republic,61,30,51,55,112,85,2.033333333333333,0.9272727272727272,1.3176470588235294
2002,Samoa,13,20,9,18,22,38,0.65,0.5,0.5789473684210527
2006,Samoa,14,19,0,0,14,19,0.7368421052631579,,0.7368421052631579
2010,Samoa,14,11,2,35,16,46,1.2727272727272727,0.05714285714285714,0.34782608695652173
2014,Samoa,5,3,8,57,13,60,1.6666666666666667,0.14035087719298245,0.21666666666666667
2018,Samoa,2,17,6,22,8,39,0.11764705882352941,0.2727272727272727,0.20512820512820512
2022,Samoa,6,18,22,32,28,50,0.3333333333333333,0.6875,0.56
2002,Somalia,0,0,2,43,2,43,,0.046511627906976744,0.046511627906976744
2006,Somalia,0,0,7,46,7,46,,0.15217391304347827,0.15217391304347827
2010,Somalia,0,0,7,62,7,62,,0.11290322580645161,0.11290322580645161
2014,Somalia,0,0,2,51,2,51,,0.0392156862745098,0.0392156862745098
2018,Somalia,0,0,2,18,2,18,,0.1111111111111111,0.1111111111111111
2022,Somalia,0,0,8,28,8,28,,0.2857142857142857,0.2857142857142857
2002,Montserrat,0,7,1,19,1,26,0.0,0.05263157894736842,0.038461538461538464
2006,Montserrat,0,7,1,20,1,27,0.0,0.05,0.037037037037037035
2010,Montserrat,0,0,4,15,4,15,,0.26666666666666666,0.26666666666666666
2014,Montserrat,2,2,4,10,6,12,1.0,0.4,0.5
2018,Montserrat,7,8,6,4,13,12,0.875,1.5,1.0833333333333333
2022,Montserrat,9,11,27,47,36,58,0.8181818181818182,0.574468085106383,0.6206896551724138
2002,Serbia,13,6,80,66,93,72,2.1666666666666665,1.2121212121212122,1.2916666666666667
2006,Serbia,25,10,59,52,84,62,2.5,1.1346153846153846,1.3548387096774193
2010,Serbia,42,20,52,45,94,65,2.1,1.1555555555555554,1.4461538461538461
2014,Serbia,37,24,41,47,78,71,1.5416666666666667,0.8723404255319149,1.0985915492957747
2018,Serbia,44,24,48,44,92,68,1.8333333333333333,1.0909090909090908,1.3529411764705883
2022,Serbia,52,25,54,44,106,69,2.08,1.2272727272727273,1.536231884057971
2002,Cook Islands,0,0,6,65,6,65,,0.09230769230769231,0.09230769230769231
2006,Cook Islands,0,0,5,26,5,26,,0.19230769230769232,0.19230769230769232
2010,Cook Islands,0,0,15,32,15,32,,0.46875,0.46875
2014,Cook Islands,0,0,12,23,12,23,,0.5217391304347826,0.5217391304347826
2018,Cook Islands,0,0,4,2,4,2,,2.0,2.0
2022,Cook Islands,0,0,5,33,5,33,,0.15151515151515152,0.15151515151515152
2002,Canary Islands,0,2,0,0,0,2,0.0,,0.0
2006,Canary Islands,2,0,0,0,2,0,,,
2010,Canary Islands,2,0,0,0,2,0,,,
2002,Bosnia and Herzegovina,29,20,23,37,52,57,1.45,0.6216216216216216,0.9122807017543859
2006,Bosnia and Herzegovina,35,27,35,45,70,72,1.2962962962962963,0.7777777777777778,0.9722222222222222
2010,Bosnia and Herzegovina,49,32,49,49,98,81,1.53125,1.0,1.2098765432098766
2014,Bosnia and Herzegovina,48,14,47,43,95,57,3.4285714285714284,1.0930232558139534,1.6666666666666667
2018,Bosnia and Herzegovina,42,20,40,42,82,62,2.1,0.9523809523809523,1.3225806451612903
2022,Bosnia and Herzegovina,34,42,23,56,57,98,0.8095238095238095,0.4107142857142857,0.5816326530612245
2002,Belize,18,8,1,15,19,23,2.25,0.06666666666666667,0.8260869565217391
2006,Belize,0,1,4,21,4,22,0.0,0.19047619047619047,0.18181818181818182
2010,Belize,3,8,20,23,23,31,0.375,0.8695652173913043,0.7419354838709677
2014,Belize,8,10,18,22,26,32,0.8,0.8181818181818182,0.8125
2018,Belize,20,12,7,14,27,26,1.6666666666666667,0.5,1.0384615384615385
2022,Belize,19,24,21,32,40,56,0.7916666666666666,0.65625,0.7142857142857143
2002,Rwanda,32,19,48,62,80,81,1.6842105263157894,0.7741935483870968,0.9876543209876543
2006,Rwanda,38,24,51,64,89,88,1.5833333333333333,0.796875,1.0113636363636365
2010,Rwanda,23,17,54,71,77,88,1.3529411764705883,0.7605633802816901,0.875
2014,Rwanda,33,29,36,47,69,76,1.1379310344827587,0.7659574468085106,0.9078947368421053
2018,Rwanda,28,19,18,26,46,45,1.4736842105263157,0.6923076923076923,1.0222222222222221
2022,Rwanda,26,13,11,20,37,33,2.0,0.55,1.121212121212121
2002,Cambodia,2,13,22,100,24,113,0.15384615384615385,0.22,0.21238938053097345
2006,Cambodia,12,13,17,69,29,82,0.9230769230769231,0.2463768115942029,0.35365853658536583
2010,Cambodia,19,14,20,73,39,87,1.3571428571428572,0.273972602739726,0.4482758620689655
2014,Cambodia,37,26,31,99,68,125,1.4230769230769231,0.31313131313131315,0.544
2018,Cambodia,46,48,19,78,65,126,0.9583333333333334,0.24358974358974358,0.5158730158730159
2022,Cambodia,30,22,20,78,50,100,1.3636363636363635,0.2564102564102564,0.5
2002,Brunei,4,29,1,27,5,56,0.13793103448275862,0.037037037037037035,0.08928571428571429
2006,Brunei,0,0,18,32,18,32,,0.5625,0.5625
2010,Brunei,0,0,16,31,16,31,,0.5161290322580645,0.5161290322580645
2014,Brunei,0,2,26,45,26,47,0.0,0.5777777777777777,0.5531914893617021
2018,Brunei,3,3,16,39,19,42,1.0,0.41025641025641024,0.4523809523809524
2022,Brunei,13,11,7,52,20,63,1.1818181818181819,0.1346153846153846,0.31746031746031744
2002,Andorra,10,30,5,76,15,106,0.3333333333333333,0.06578947368421052,0.14150943396226415
2006,Andorra,4,44,4,77,8,121,0.09090909090909091,0.05194805194805195,0.06611570247933884
2010,Andorra,3,48,5,75,8,123,0.0625,0.06666666666666667,0.06504065040650407
2014,Andorra,5,46,2,66,7,112,0.10869565217391304,0.030303030303030304,0.0625
2018,Andorra,8,38,4,59,12,97,0.21052631578947367,0.06779661016949153,0.12371134020618557
2022,Andorra,15,50,12,59,27,109,0.3,0.2033898305084746,0.24770642201834864
2002,British Virgin Islands,25,24,2,37,27,61,1.0416666666666667,0.05405405405405406,0.4426229508196721
2006,British Virgin Islands,9,6,4,16,13,22,1.5,0.25,0.5909090909090909
2010,British Virgin Islands,3,3,7,13,10,16,1.0,0.5384615384615384,0.625
2014,British Virgin Islands,4,6,2,6,6,12,0.6666666666666666,0.3333333333333333,0.5
2018,British Virgin Islands,0,0,14,35,14,35,,0.4,0.4
2022,British Virgin Islands,6,10,14,60,20,70,0.6,0.23333333333333334,0.2857142857142857
2002,Palestine,0,0,33,56,33,56,,0.5892857142857143,0.5892857142857143
2006,Palestine,1,1,41,58,42,59,1.0,0.7068965517241379,0.711864406779661
2010,Palestine,13,5,31,62,44,67,2.6,0.5,0.6567164179104478
2014,Palestine,20,5,87,72,107,77,4.0,1.2083333333333333,1.3896103896103895
2018,Palestine,32,7,45,47,77,54,4.571428571428571,0.9574468085106383,1.4259259259259258
2022,Palestine,2,0,46,49,48,49,,0.9387755102040817,0.9795918367346939
2002,Catalonia,16,13,0,0,16,13,1.2307692307692308,,1.2307692307692308
2006,Catalonia,13,15,1,1,14,16,0.8666666666666667,1.0,0.875
2010,Catalonia,10,4,1,1,11,5,2.5,1.0,2.2
2014,Catalonia,8,6,1,1,9,7,1.3333333333333333,1.0,1.2857142857142858
2018,Catalonia,5,5,0,0,5,5,1.0,,1.0
2022,Catalonia,2,1,0,0,2,1,2.0,,2.0
2002,United States Virgin Islands,1,20,3,41,4,61,0.05,0.07317073170731707,0.06557377049180328
2006,United States Virgin Islands,0,4,2,30,2,34,0.0,0.06666666666666667,0.058823529411764705
2010,United States Virgin Islands,3,18,4,34,7,52,0.16666666666666666,0.11764705882352941,0.1346153846153846
2014,United States Virgin Islands,3,22,4,25,7,47,0.13636363636363635,0.16,0.14893617021276595
2018,United States Virgin Islands,1,12,6,21,7,33,0.08333333333333333,0.2857142857142857,0.21212121212121213
2022,United States Virgin Islands,12,37,9,25,21,62,0.32432432432432434,0.36,0.3387096774193548
2010,Corsica,2,1,0,0,2,1,2.0,,2.0
2014,Corsica,3,1,0,0,3,1,3.0,,3.0
2018,Corsica,3,2,0,0,3,2,1.5,,1.5
2006,Brittany,3,1,0,0,3,1,3.0,,3.0
2010,Brittany,3,2,0,0,3,2,1.5,,1.5
2014,Brittany,1,1,0,0,1,1,1.0,,1.0
2002,Equatorial Guinea,8,10,8,32,16,42,0.8,0.25,0.38095238095238093
2006,Equatorial Guinea,17,8,3,23,20,31,2.125,0.13043478260869565,0.6451612903225806
2010,Equatorial Guinea,22,15,7,36,29,51,1.4666666666666666,0.19444444444444445,0.5686274509803921
2014,Equatorial Guinea,32,23,10,35,42,58,1.391304347826087,0.2857142857142857,0.7241379310344828
2018,Equatorial Guinea,20,15,15,26,35,41,1.3333333333333333,0.5769230769230769,0.8536585365853658
2022,Equatorial Guinea,20,6,35,40,55,46,3.3333333333333335,0.875,1.1956521739130435
2002,São Tomé and Príncipe,3,2,4,29,7,31,1.5,0.13793103448275862,0.22580645161290322
2006,São Tomé and Príncipe,0,1,1,11,1,12,0.0,0.09090909090909091,0.08333333333333333
2010,São Tomé and Príncipe,3,6,3,5,6,11,0.5,0.6,0.5454545454545454
2014,São Tomé and Príncipe,7,14,4,23,11,37,0.5,0.17391304347826086,0.2972972972972973
2018,São Tomé and Príncipe,6,10,10,35,16,45,0.6,0.2857142857142857,0.35555555555555557
2022,São Tomé and Príncipe,2,5,15,59,17,64,0.4,0.2542372881355932,0.265625
2002,Eritrea,4,4,13,46,17,50,1.0,0.2826086956521739,0.34
2006,Eritrea,5,4,17,39,22,43,1.25,0.4358974358974359,0.5116279069767442
2010,Eritrea,5,6,17,35,22,41,0.8333333333333334,0.4857142857142857,0.5365853658536586
2014,Eritrea,1,6,4,18,5,24,0.16666666666666666,0.2222222222222222,0.20833333333333334
2018,Eritrea,1,4,1,5,2,9,0.25,0.2,0.2222222222222222
2022,Eritrea,1,2,0,2,1,4,0.5,0.0,0.25
2002,Bahamas,4,11,3,20,7,31,0.36363636363636365,0.15,0.22580645161290322
2006,Bahamas,5,7,0,19,5,26,0.7142857142857143,0.0,0.19230769230769232
2010,Bahamas,9,3,4,13,13,16,3.0,0.3076923076923077,0.8125
2014,Bahamas,6,5,4,3,10,8,1.2,1.3333333333333333,1.25
2018,Bahamas,12,14,5,12,17,26,0.8571428571428571,0.4166666666666667,0.6538461538461539
2022,Bahamas,19,25,22,56,41,81,0.76,0.39285714285714285,0.5061728395061729
2002,Micronesia,7,0,1,59,8,59,,0.01694915254237288,0.13559322033898305
2006,Micronesia,0,0,0,52,0,52,,0.0,0.0
2002,Bhutan,6,0,4,94,10,94,,0.0425531914893617,0.10638297872340426
2006,Bhutan,6,0,11,62,17,62,,0.1774193548387097,0.27419354838709675
2010,Bhutan,0,0,13,72,13,72,,0.18055555555555555,0.18055555555555555
2014,Bhutan,8,19,10,94,18,113,0.42105263157894735,0.10638297872340426,0.1592920353982301
2018,Bhutan,11,27,5,107,16,134,0.4074074074074074,0.04672897196261682,0.11940298507462686
2022,Bhutan,4,1,4,24,8,25,4.0,0.16666666666666666,0.32
2002,Kernow,2,2,7,1,9,3,1.0,7.0,3.0
2006,Kernow,5,3,4,1,9,4,1.6666666666666667,4.0,2.25
2010,Kernow,1,1,0,0,1,1,1.0,,1.0
2018,Kernow,5,0,0,0,5,0,,,
2022,Kernow,5,0,0,0,5,0,,,
2002,Djibouti,2,4,10,48,12,52,0.5,0.20833333333333334,0.23076923076923078
2006,Djibouti,3,16,6,67,9,83,0.1875,0.08955223880597014,0.10843373493975904
2010,Djibouti,3,20,8,76,11,96,0.15,0.10526315789473684,0.11458333333333333
2014,Djibouti,0,16,4,43,4,59,0.0,0.09302325581395349,0.06779661016949153
2018,Djibouti,5,14,3,44,8,58,0.35714285714285715,0.06818181818181818,0.13793103448275862
2022,Djibouti,4,2,10,48,14,50,2.0,0.20833333333333334,0.28
2002,American Samoa,0,0,4,122,4,122,,0.03278688524590164,0.03278688524590164
2006,American Samoa,0,0,2,72,2,72,,0.027777777777777776,0.027777777777777776
2010,American Samoa,0,0,4,67,4,67,,0.05970149253731343,0.05970149253731343
2014,American Samoa,0,0,9,39,9,39,,0.23076923076923078,0.23076923076923078
2018,American Samoa,0,0,8,46,8,46,,0.17391304347826086,0.17391304347826086
2022,American Samoa,0,0,4,69,4,69,,0.057971014492753624,0.057971014492753624
2002,Monaco,0,0,4,8,4,8,,0.5,0.5
2006,Monaco,0,0,21,19,21,19,,1.105263157894737,1.105263157894737
2010,Monaco,0,0,8,13,8,13,,0.6153846153846154,0.6153846153846154
2014,Monaco,0,0,8,19,8,19,,0.42105263157894735,0.42105263157894735
2002,Afghanistan,0,2,2,22,2,24,0.0,0.09090909090909091,0.08333333333333333
2006,Afghanistan,0,2,15,62,15,64,0.0,0.24193548387096775,0.234375
2010,Afghanistan,0,0,28,42,28,42,,0.6666666666666666,0.6666666666666666
2014,Afghanistan,3,0,69,61,72,61,,1.1311475409836065,1.180327868852459
2018,Afghanistan,0,0,45,66,45,66,,0.6818181818181818,0.6818181818181818
2022,Afghanistan,0,0,25,57,25,57,,0.43859649122807015,0.43859649122807015
2002,Tuvalu,0,0,3,20,3,20,,0.15,0.15
2006,Tuvalu,0,0,5,42,5,42,,0.11904761904761904,0.11904761904761904
2010,Tuvalu,0,0,12,42,12,42,,0.2857142857142857,0.2857142857142857
2014,Tuvalu,0,0,10,20,10,20,,0.5,0.5
2018,Tuvalu,0,0,8,70,8,70,,0.11428571428571428,0.11428571428571428
2022,Tuvalu,0,0,10,52,10,52,,0.19230769230769232,0.19230769230769232
2002,Kiribati,0,0,2,40,2,40,,0.05,0.05
2006,Kiribati,0,0,2,40,2,40,,0.05,0.05
2010,Kiribati,0,0,2,46,2,46,,0.043478260869565216,0.043478260869565216
2014,Kiribati,0,0,2,46,2,46,,0.043478260869565216,0.043478260869565216
2002,Mayotte,1,1,0,1,1,2,1.0,0.0,0.5
2006,Mayotte,1,1,3,5,4,6,1.0,0.6,0.6666666666666666
2010,Mayotte,2,2,2,4,4,6,1.0,0.5,0.6666666666666666
2006,Comoros,0,4,2,11,2,15,0.0,0.18181818181818182,0.13333333333333333
2010,Comoros,2,9,5,30,7,39,0.2222222222222222,0.16666666666666666,0.1794871794871795
2014,Comoros,4,7,7,23,11,30,0.5714285714285714,0.30434782608695654,0.36666666666666664
2018,Comoros,11,8,20,40,31,48,1.375,0.5,0.6458333333333334
2022,Comoros,21,9,40,52,61,61,2.3333333333333335,0.7692307692307693,1.0
2002,Turks and Caicos Islands,0,0,0,24,0,24,,0.0,0.0
2006,Turks and Caicos Islands,2,1,0,9,2,10,2.0,0.0,0.2
2010,Turks and Caicos Islands,2,5,0,8,2,13,0.4,0.0,0.15384615384615385
2014,Turks and Caicos Islands,2,10,2,12,4,22,0.2,0.16666666666666666,0.18181818181818182
2018,Turks and Caicos Islands,8,21,10,41,18,62,0.38095238095238093,0.24390243902439024,0.2903225806451613
2022,Turks and Caicos Islands,10,31,21,58,31,89,0.3225806451612903,0.3620689655172414,0.34831460674157305
2002,Timor-Leste,0,0,4,21,4,21,,0.19047619047619047,0.19047619047619047
2006,Timor-Leste,0,0,16,58,16,58,,0.27586206896551724,0.27586206896551724
2010,Timor-Leste,0,0,21,55,21,55,,0.38181818181818183,0.38181818181818183
2014,Timor-Leste,0,19,22,73,22,92,0.0,0.3013698630136986,0.2391304347826087
2018,Timor-Leste,0,19,19,92,19,111,0.0,0.20652173913043478,0.17117117117117117
2022,Timor-Leste,0,0,15,68,15,68,,0.22058823529411764,0.22058823529411764
2006,Occitania,17,4,1,1,18,5,4.25,1.0,3.6
2010,Occitania,23,7,0,0,23,7,3.2857142857142856,,3.2857142857142856
2014,Occitania,21,5,7,1,28,6,4.2,7.0,4.666666666666667
2006,Chechnya,0,0,3,29,3,29,,0.10344827586206896,0.10344827586206896
2006,Galicia,8,6,0,0,8,6,1.3333333333333333,,1.3333333333333333
2010,Galicia,4,3,0,0,4,3,1.3333333333333333,,1.3333333333333333
2014,Galicia,2,8,0,0,2,8,0.25,,0.25
2018,Galicia,1,1,0,0,1,1,1.0,,1.0
2006,Northern Cyprus,3,2,1,2,4,4,1.5,0.5,1.0
2010,Northern Cyprus,0,0,1,2,1,2,,0.5,0.5
2018,Northern Cyprus,12,2,0,0,12,2,6.0,,6.0
2006,Kosovo,0,0,7,1,7,1,,7.0,7.0
2014,Kosovo,6,8,4,15,10,23,0.75,0.26666666666666666,0.43478260869565216
2018,Kosovo,27,17,29,43,56,60,1.588235294117647,0.6744186046511628,0.9333333333333333
2022,Kosovo,44,36,36,45,80,81,1.2222222222222223,0.8,0.9876543209876543
2002,Tibet,0,0,2,6,2,6,,0.3333333333333333,0.3333333333333333
2006,Tibet,0,0,0,3,0,3,,0.0,0.0
2010,Tibet,0,0,0,3,0,3,,0.0,0.0
2022,Tibet,0,0,3,3,3,3,,1.0,1.0
2010,Sápmi,0,0,2,3,2,3,,0.6666666666666666,0.6666666666666666
2014,Sápmi,0,0,2,3,2,3,,0.6666666666666666,0.6666666666666666
2018,Sápmi,0,0,5,14,5,14,,0.35714285714285715,0.35714285714285715
2022,Sápmi,0,0,5,14,5,14,,0.35714285714285715,0.35714285714285715
2006,Silesia,1,1,0,0,1,1,1.0,,1.0
2006,Montenegro,14,8,5,9,19,17,1.75,0.5555555555555556,1.1176470588235294
2010,Montenegro,39,21,23,30,62,51,1.8571428571428572,0.7666666666666667,1.2156862745098038
2014,Montenegro,29,21,30,39,59,60,1.380952380952381,0.7692307692307693,0.9833333333333333
2018,Montenegro,34,29,24,38,58,67,1.1724137931034482,0.631578947368421,0.8656716417910447
2022,Montenegro,41,44,22,41,63,85,0.9318181818181818,0.5365853658536586,0.7411764705882353
2002,Northern Mariana Islands,0,0,0,7,0,7,,0.0,0.0
2006,Northern Mariana Islands,4,6,0,9,4,15,0.6666666666666666,0.0,0.26666666666666666
2010,Northern Mariana Islands,5,7,5,37,10,44,0.7142857142857143,0.13513513513513514,0.22727272727272727
2014,Northern Mariana Islands,0,0,5,56,5,56,,0.08928571428571429,0.08928571428571429
2018,Northern Mariana Islands,0,0,2,25,2,25,,0.08,0.08
2022,Northern Mariana Islands,0,0,5,19,5,19,,0.2631578947368421,0.2631578947368421
2006,Romani people,0,0,3,1,3,1,,3.0,3.0
2010,Romani people,0,0,5,12,5,12,,0.4166666666666667,0.4166666666666667
2014,Romani people,0,0,9,21,9,21,,0.42857142857142855,0.42857142857142855
2018,Romani people,0,0,7,10,7,10,,0.7,0.7
2006,Provence,0,0,3,2,3,2,,1.5,1.5
2010,Provence,0,0,3,2,3,2,,1.5,1.5
2014,Provence,6,1,0,0,6,1,6.0,,6.0
2014,Padania,0,0,15,3,15,3,,5.0,5.0
2018,Padania,0,0,30,10,30,10,,3.0,3.0
2022,Padania,0,0,10,5,10,5,,2.0,2.0
2010,Gozo,17,1,0,0,17,1,17.0,,17.0
2014,Gozo,17,1,0,0,17,1,17.0,,17.0
2018,Bonaire,0,0,13,22,13,22,,0.5909090909090909,0.5909090909090909
2022,Bonaire,5,9,31,28,36,37,0.5555555555555556,1.1071428571428572,0.972972972972973
2010,Chagos Islands,0,0,9,2,9,2,,4.5,4.5
2014,Chagos Islands,0,0,13,11,13,11,,1.1818181818181819,1.1818181818181819
2018,Chagos Islands,0,0,5,26,5,26,,0.19230769230769232,0.19230769230769232
2022,Chagos Islands,0,0,3,12,3,12,,0.25,0.25
2002,Sealand,0,0,2,2,2,2,,1.0,1.0
2006,Sealand,0,0,2,2,2,2,,1.0,1.0
2010,Sealand,0,0,2,4,2,4,,0.5,0.5
2014,Sealand,0,0,20,13,20,13,,1.5384615384615385,1.5384615384615385
2010,Raetia,0,0,4,24,4,24,,0.16666666666666666,0.16666666666666666
2014,Raetia,1,6,7,32,8,38,0.16666666666666666,0.21875,0.21052631578947367
2018,Raetia,3,4,2,7,5,11,0.75,0.2857142857142857,0.45454545454545453
2022,Raetia,11,8,3,8,14,16,1.375,0.375,0.875
2018,Tamil Eelam,0,0,5,0,5,0,,,
2010,South Sudan,2,2,0,7,2,9,1.0,0.0,0.2222222222222222
2014,South Sudan,5,8,7,38,12,46,0.625,0.18421052631578946,0.2608695652173913
2018,South Sudan,11,15,12,42,23,57,0.7333333333333333,0.2857142857142857,0.40350877192982454
2022,South Sudan,3,8,21,45,24,53,0.375,0.4666666666666667,0.4528301886792453
2010,Saint Barthélemy,1,8,0,3,1,11,0.125,0.0,0.09090909090909091
2014,Saint Barthélemy,1,8,0,0,1,8,0.125,,0.125
2018,Saint Barthélemy,16,14,1,1,17,15,1.1428571428571428,1.0,1.1333333333333333
2022,Saint Barthélemy,9,4,3,4,12,8,2.25,0.75,1.5
2010,Abkhazia,1,1,0,3,1,4,1.0,0.0,0.25
2014,Abkhazia,3,1,0,3,3,4,3.0,0.0,0.75
2018,Abkhazia,3,2,11,9,14,11,1.5,1.2222222222222223,1.2727272727272727
2022,Abkhazia,0,0,6,3,6,3,,2.0,2.0
2010,Artsakh,3,0,1,1,4,1,,1.0,4.0
2014,Artsakh,3,0,1,1,4,1,,1.0,4.0
2018,Artsakh,9,8,0,0,9,8,1.125,,1.125
2022,Artsakh,9,8,0,0,9,8,1.125,,1.125
2014,Madrid,1,2,0,0,1,2,0.5,,0.5
2014,Saugeais,1,1,0,0,1,1,1.0,,1.0
2014,Ellan Vannin,10,0,6,11,16,11,,0.5454545454545454,1.4545454545454546
2018,Ellan Vannin,0,0,14,16,14,16,,0.875,0.875
2010,Vatican City,0,0,2,11,2,11,,0.18181818181818182,0.18181818181818182
2014,Vatican City,0,2,2,13,2,15,0.0,0.15384615384615385,0.13333333333333333
2018,Vatican City,2,2,0,0,2,2,1.0,,1.0
2022,Vatican City,2,2,0,0,2,2,1.0,,1.0
2014,Somaliland,0,0,2,2,2,2,,1.0,1.0
2018,Somaliland,0,0,2,6,2,6,,0.3333333333333333,0.3333333333333333
2022,Somaliland,0,0,2,6,2,6,,0.3333333333333333,0.3333333333333333
2014,Franconia,4,2,0,0,4,2,2.0,,2.0
2018,Franconia,0,0,4,3,4,3,,1.3333333333333333,1.3333333333333333
2022,Franconia,0,0,4,3,4,3,,1.3333333333333333,1.3333333333333333
2018,South Ossetia,2,0,12,24,14,24,,0.5,0.5833333333333334
2022,South Ossetia,2,0,10,8,12,8,,1.25,1.5
2014,County of Nice,0,0,11,8,11,8,,1.375,1.375
2018,County of Nice,0,0,11,8,11,8,,1.375,1.375
2014,Seborga,2,3,0,0,2,3,0.6666666666666666,,0.6666666666666666
2014,Székely Land,8,10,0,0,8,10,0.8,,0.8
2018,Székely Land,5,10,14,23,19,33,0.5,0.6086956521739131,0.5757575757575758
2022,Székely Land,0,0,5,16,5,16,,0.3125,0.3125
2014,Panjab,0,2,13,2,13,4,0.0,6.5,3.25
2018,Panjab,0,2,26,9,26,11,0.0,2.888888888888889,2.3636363636363638
2022,Panjab,0,0,6,0,6,0,,,
2014,Felvidék,0,0,5,11,5,11,,0.45454545454545453,0.45454545454545453
2018,Felvidék,0,0,8,14,8,14,,0.5714285714285714,0.5714285714285714
2014,Luhansk PR,3,1,2,6,5,7,3.0,0.3333333333333333,0.7142857142857143
2018,Luhansk PR,7,4,2,8,9,12,1.75,0.25,0.75
2022,Luhansk PR,4,3,0,2,4,5,1.3333333333333333,0.0,0.8
2014,Donetsk PR,5,2,1,4,6,6,2.5,0.25,1.0
2018,Donetsk PR,5,2,3,5,8,7,2.5,0.6,1.1428571428571428
2014,United Koreans in Japan,0,0,9,0,9,0,,,
2018,United Koreans in Japan,0,0,9,0,9,0,,,
2018,Western Armenia,0,0,8,5,8,5,,1.6,1.6
2022,Western Armenia,0,0,8,5,8,5,,1.6,1.6
2018,Barawa,7,11,0,5,7,16,0.6363636363636364,0.0,0.4375
2022,Barawa,0,0,0,5,0,5,,0.0,0.0
2014,Ryūkyū,0,0,0,9,0,9,,0.0,0.0
2018,Ryūkyū,0,0,0,9,0,9,,0.0,0.0
2018,Kárpátalja,0,0,9,7,9,7,,1.2857142857142858,1.2857142857142858
2018,Yorkshire,18,7,8,4,26,11,2.5714285714285716,2.0,2.3636363636363638
2022,Yorkshire,6,2,0,0,6,2,3.0,,3.0
2022,Matabeleland,0,0,2,2,2,2,,1.0,1.0
2018,Cascadia,6,3,0,0,6,3,2.0,,2.0
2022,Cascadia,6,3,0,0,6,3,2.0,,2.0
2018,Parishes of Jersey,2,1,0,0,2,1,2.0,,2.0
2018,Chameria,0,0,9,4,9,4,,2.25,2.25
2022,Chameria,0,0,9,4,9,4,,2.25,2.25
2018,Saint Helena,0,0,2,7,2,7,,0.2857142857142857,0.2857142857142857
2022,Saint Helena,0,0,2,7,2,7,,0.2857142857142857,0.2857142857142857
2022,Yoruba Nation,0,0,1,2,1,2,,0.5,0.5
2022,Biafra,0,0,2,1,2,1,,2.0,2.0
2022,Elba Island,5,0,0,0,5,0,,,
2022,West Papua,0,0,1,1,1,1,,1.0,1.0
2022,Ticino,0,0,1,5,1,5,,0.2,0.2
2006,Ambazonia,0,0,3,5,3,5,,0.6,0.6
2010,Ambazonia,0,0,1,3,1,3,,0.3333333333333333,0.3333333333333333
2010,Cilento,0,0,0,2,0,2,,0.0,0.0
2014,Cilento,0,0,0,2,0,2,,0.0,0.0
2018,Surrey,0,0,3,1,3,1,,3.0,3.0
